Root	Comparative
able	abler
absurd	absurder
acute	acuter
airy	airier
ancient	more ancient
angry	angrier
antsy	antsier
awesome	more awesome
awful	awfuller
bad	worse
bald	balder
balmy	balmier
bare	barer
batty	battier
bawdy	bawdier
beautiful	more beautiful
beefy	beefier
big	bigger
bitchy	bitchier
bitter	bitterer
black	blacker
bland	blander
blank	blanker
bleak	bleaker
blind	blinder
blithe	blither
blond	blonder
bloody	bloodier
blue	bluer
blunt	blunter
blurry	blurrier
bold	bolder
bony	bonier
bored	more bored
boring	more boring
bouncy	bouncier
brash	brasher
brassy	brassier
brave	braver
brawny	brawnier
breezy	breezier
brief	briefer
bright	brighter
brilliant	more brilliant
brisk	brisker
brittle	brittler
broad	broader
broke	broker
broody	broodier
brown	browner
bubbly	bubblier
buff	buffer
bulky	bulkier
bumpy	bumpier
burly	burlier
bushy	bushier
busy	busier
butch	butcher
calm	calmer
camp	camper
canny	cannier
catchy	catchier
catty	cattier
chaste	chaster
chatty	chattier
cheap	cheaper
cheeky	cheekier
cheerful	cheerfuller
cheery	cheerier
cheesy	cheesier
chewy	chewier
chic	chicer
chill	chiller
chilly	chillier
chirpy	chirpier
choppy	choppier
chubby	chubbier
chunky	chunkier
clammy	clammier
classy	classier
clean	cleaner
clear	clearer
clever	cleverer
close	closer
cloudy	cloudier
clumsy	clumsier
clunky	clunkier
coarse	coarser
cocky	cockier
cold	colder
comfy	comfier
common	commoner
compact	compacter
complete	completer
complex	more complex
cool	cooler
corny	cornier
correct	more correct
cosy	more cosy
costly	costlier
coy	coyer
cozy	cozier
crafty	craftier
craggy	craggier
cranky	crankier
crass	crasser
crazy	crazier
creaky	creakier
creamy	creamier
creepy	creepier
crisp	crisper
crispy	crispier
crooked	crookeder
cross	crosser
crude	cruder
cruel	crueler
crumbly	crumblier
crunchy	crunchier
crusty	crustier
cuddly	cuddlier
cunning	more cunning
curious	curiouser
curly	curlier
curvy	curvier
cushy	cushier
cut	cuter
daft	dafter
dainty	daintier
damp	damper
dank	danker
dark	darker
dead	deader
deadly	deadlier
deaf	deafer
dear	dearer
decent	decenter
deep	deeper
deft	defter
dense	denser
diffuse	diffuser
dim	dimmer
dingy	dingier
dire	more dire
dirty	dirtier
dizzy	dizzier
doughy	doughier
drab	drabber
drafty	draftier
dreamy	dreamier
dreary	drearier
dressy	dressier
dry	drier
droopy	droopier
drunk	drunker
dull	duller
dumb	dumber
dumpy	dumpier
dusty	dustier
earthy	earthier
edgy	edgier
empty	emptier
evil	more evil
expensive	more expensive
faint	fainter
fair	fairer
fake	faker
false	falser
famous	more famous
fast	faster
fat	fatter
fatty	fattier
feeble	feebler
feisty	feistier
fierce	fiercer
fiery	fierier
filthy	filthier
fine	finer
firm	firmer
fishy	fishier
fit	fitter
flabby	flabbier
flaky	flakier
flashy	flashier
flat	flatter
fleet	fleeter
fleshy	fleshier
flighty	flightier
flimsy	flimsier
floppy	floppier
fluffy	fluffier
foamy	foamier
folksy	folksier
foolish	more foolish
foreign	more foreign
foul	fouler
frail	more frail
frank	franker
free	freer
fresh	fresher
friendly	friendlier
frisky	friskier
frizzy	frizzier
frosty	frostier
frothy	frothier
fruity	fruitier
frumpy	frumpier
fugly	fuglier
full	fuller
funky	funkier
fun	funnier
funny	funnier
furry	furrier
fussy	fussier
fuzzy	fuzzier
game	gamer
gaudy	gaudier
gaunt	gaunter
gay	gayer
gentle	gentler
giddy	giddier
glad	gladder
glib	glibber
gloomy	gloomier
glossy	glossier
godly	godlier
gold	more golden
goofy	goofier
grand	grander
grave	graver
gray	grayer
greasy	greasier
great	greater
greedy	greedier
green	greener
grey	more grey
grimy	grimier
grim	grimmer
gritty	grittier
groggy	groggier
gross	grosser
gruff	gruffer
grumpy	grumpier
guilty	guiltier
hairy	hairier
handy	handier
handsome	handsomer
happy	happier
hard	harder
hardy	hardier
harsh	harsher
haughty	haughtier
hazy	hazier
heady	headier
healthy	healthier
heavy	heavier
hefty	heftier
high	higher
hoarse	hoarser
holy	holier
hollow	hollower
homely	homelier
honest	honester
horny	hornier
hot	hotter
huge	huger
humble	humbler
hungry	hungrier
husky	huskier
icy	icier
idle	idler
ill	more ill
intense	intenser
itchy	itchier
jolly	jollier
juicy	juicier
jumpy	jumpier
keen	keener
kind	kinder
kinky	kinkier
lame	lamer
lanky	lankier
large	larger
lazy	lazier
leaky	leakier
lean	leaner
left	more left
leggy	leggier
lengthy	lengthier
light	lighter
limp	limper
lit	liter
lively	livelier
lofty	loftier
lonely	lonelier
lonesome	more lonesome
long	longer
loony	loonier
loopy	loopier
loose	looser
lordly	more lordly
lost	more lost
loud	louder
lovely	lovelier
lowly	lowlier
lucky	luckier
lush	lusher
lusty	lustier
mad	madder
manly	manlier
mature	more mature
mean	meaner
meaty	meatier
meek	meeker
mellow	mellower
merry	merrier
messy	messier
mighty	mightier
mild	milder
milky	milkier
minute	more minute
modern	more modern
moist	moister
moody	moodier
mucky	muckier
muddy	muddier
murky	murkier
mushy	mushier
musty	mustier
mute	muter
naked	nakeder
narrow	narrower
nasty	nastier
naughty	naughtier
neat	neater
new	newer
nice	nicer
nimble	nimbler
noble	nobler
noisy	noisier
numb	number
nutty	nuttier
odd	odder
oily	oilier
old	older
open	opener
orange	oranger
ornery	ornerier
pale	paler
pasty	pastier
patchy	patchier
peachy	peachier
peppy	peppier
perfect	perfecter
perky	perkier
phony	phonier
pink	pinker
plain	plainer
pleasant	pleasanter
plucky	pluckier
plump	plumper
plush	plusher
polite	politer
poor	poorer
powerful	more powerful
pretty	prettier
prickly	pricklier
prim	primer
private	privateer
profound	profounder
prompt	prompter
proud	prouder
puffy	puffier
puny	punier
punk	punker
pure	purer
purple	purpler
quaint	quainter
queer	queerer
quick	quicker
quiet	quieter
quirky	quirkier
racy	racier
randy	randier
random	more random
rangy	rangier
rank	ranker
rapid	rapider
rare	rarer
raunchy	raunchier
raw	rawer
red	redder
remote	remoter
rich	richer
ripe	riper
risky	riskier
robust	more robust
rocky	rockier
roomy	roomier
rosy	rosier
rotten	rottener
rough	rougher
round	rounder
rowdy	rowdier
rude	ruder
rugged	ruggeder
runny	runnier
rusty	rustier
sacred	more sacred
sad	sadder
safe	safer
saintly	saintlier
salty	saltier
sandy	sandier
sappy	sappier
scaly	scalier
scarce	scarcer
scared	more scared
scary	scarier
scrappy	scrappier
scratchy	scratchier
scrawny	scrawnier
scummy	scummier
secure	more secure
seedy	seedier
serene	more serene
set	setter
severe	severer
sexy	sexier
shabby	shabbier
shady	shadier
shaggy	shaggier
shaky	shakier
shallow	shallower
shapely	shapelier
sharp	sharper
sheer	sheerer
shy	shier
shifty	shiftier
shiny	shinier
short	shorter
shot	more shot
showy	showier
shrewd	shrewder
shrill	shriller
sick	sicker
silent	silenter
silky	silkier
silly	sillier
simple	simpler
sincere	sincerer
skimpy	skimpier
skinny	skinnier
sleazy	sleazier
sleek	sleeker
sleepy	sleepier
slender	slenderer
slick	slicker
slight	slighter
slim	slimmer
slimy	slimier
slippery	slipperier
slippy	slippier
sloppy	sloppier
slow	slower
sly	slyer
small	smaller
smart	smarter
smelly	smellier
smoky	smokier
smooth	smoother
smug	smugger
snappy	snappier
sneaky	sneakier
snowy	snowier
snug	snugger
sober	soberer
soft	softer
soggy	soggier
solid	solider
soppy	soppier
sore	sorer
sorry	sorrier
sound	sounder
sour	sourer
sparkly	sparklier
sparse	sparser
special	more special
speedy	speedier
spicy	spicier
spiky	spikier
spindly	spindlier
splashy	splashier
spongy	spongier
spooky	spookier
sporty	sportier
spotty	spottier
spread	spreader
spry	sprier
sprightly	sprightlier
springy	springier
spunky	spunkier
square	squarer
squat	squatter
squishy	squishier
stable	stabler
stale	staler
stark	starker
stately	statelier
staunch	stauncher
steady	steadier
stealthy	stealthier
steamy	steamier
steely	steelier
steep	steeper
stern	sterner
sticky	stickier
stiff	stiffer
still	stiller
stingy	stingier
stinky	stinkier
stout	stouter
straight	straighter
strange	stranger
stretchy	stretchier
strict	stricter
stringy	stringier
strong	stronger
stubborn	stubborner
stupid	stupider
sturdy	sturdier
suave	suaver
sublime	sublimer
subtle	subtler
sunny	sunnier
supple	suppler
swanky	swankier
swarthy	swarthier
sweet	sweeter
swift	swifter
tall	taller
tame	tamer
tangy	tangier
tan	tanner
tart	tarter
tasty	tastier
taut	tauter
tawny	tawnier
teeny	teenier
tender	tenderer
tense	tenser
terrible	more terrible
terse	terser
thick	thicker
thin	thiner
thirsty	thirstier
thorny	thornier
tidy	tidier
tight	tighter
timid	timider
tiny	tinier
tinny	tinnier
tired	tireder
tough	tougher
tricky	trickier
trim	trimmer
true	truer
trusty	trustier
trustworthy	trustworthier
twisty	twistier
ugly	uglier
uneasy	uneasier
unhappy	unhappier
unhealthy	unhealthier
unkind	unkinder
unlucky	unluckier
unsafe	unsafer
untidy	untidier
vague	vaguer
vain	vainer
vast	vaster
vile	viler
vivid	vivider
wacky	wackier
wary	warier
warm	warmer
wavy	wavier
weak	weaker
wealthy	wealthier
weighty	weightier
weird	weirder
welcome	welcomer
western	westerner
wet	wetter
whacky	whackier
white	whiter
wholesome	more wholesome
wicked	wickeder
wide	wider
wild	wilder
wily	wilier
windy	windier
wise	wiser
wispy	wispier
witty	wittier
wobbly	wobblier
woody	woodier
woolly	woollier
worthy	worthier
wrinkly	wrinklier
wrong	wronger
yellow	yellower
young	younger
yummy	yummier
Byzantine	more Byzantine
Catholic	more Catholic
Christian	more Christian
abandoned	more abandoned
abhorrent	more abhorrent
abiding	more abiding
abnormal	more abnormal
aboriginal	more aboriginal
aborted	more aborted
abraded	more abraded
abrasive	more abrasive
abridged	more abridged
abroad	more abroad
abrupt	more abrupt
absent	more absent
absentminded	more absentminded
absolute	more absolute
absorbent	more absorbent
absorbing	more absorbing
abstinent	more abstinent
abstract	more abstract
abundant	more abundant
abused	more abused
abusing	more abusing
abusive	more abusive
abutting	more abutting
accelerating	more accelerating
acceptable	more acceptable
accepted	more accepted
accepting	more accepting
accessible	more accessible
acclaimed	more acclaimed
accommodated	more accommodated
accommodating	more accommodating
accompanying	more accompanying
accomplished	more accomplished
accountable	more accountable
accounting	more accounting
accredited	more accredited
accrued	more accrued
accumulated	more accumulated
accumulating	more accumulating
accurate	more accurate
accused	more accused
accusing	more accusing
acerbic	more acerbic
achieved	more achieved
aching	more aching
acid	more acid
acidic	more acidic
acknowledged	more acknowledged
acknowledging	more acknowledging
acquired	more acquired
acrid	more acrid
acrobatic	more acrobatic
acting	more acting
activated	more activated
activating	more activating
active	more active
activist	more activist
actuating	more actuating
adaptable	more adaptable
adapting	more adapting
adaptive	more adaptive
addicted	more addicted
addicting	more addicting
addictive	more addictive
adding	more adding
addled	more addled
addressed	more addressed
adept	more adept
adequate	more adequate
adhering	more adhering
adjoining	more adjoining
adjustable	more adjustable
adjusted	more adjusted
administered	more administered
administering	more administering
admirable	more admirable
admired	more admired
admiring	more admiring
admitted	more admitted
adolescent	more adolescent
adopted	more adopted
adopting	more adopting
adorable	more adorable
adored	more adored
adoring	more adoring
adorned	more adorned
adorning	more adorning
adroit	more adroit
advanced	more advanced
advancing	more advancing
advantageous	more advantageous
adventuring	more adventuring
adventurous	more adventurous
advertised	more advertised
advertising	more advertising
advising	more advising
advocating	more advocating
aerated	more aerated
aerodynamic	more aerodynamic
aesthetic	more aesthetic
affable	more affable
affecting	more affecting
affectionate	more affectionate
affirmative	more affirmative
affirmed	more affirmed
affluent	more affluent
affordable	more affordable
afraid	more afraid
aged	more aged
ageless	more ageless
aggravated	more aggravated
aggravating	more aggravating
aggregating	more aggregating
aggressive	more aggressive
agile	more agile
aging	more aging
agitated	more agitated
agitating	more agitating
agonizing	more agonizing
agreeable	more agreeable
agreed	more agreed
aiding	more aiding
aimed	more aimed
aiming	more aiming
aimless	more aimless
airbrushed	more airbrushed
airless	more airless
airtight	more airtight
alarming	more alarming
alcoholic	more alcoholic
alert	more alert
alerted	more alerted
alerting	more alerting
alien	more alien
alienated	more alienated
aligned	more aligned
alive	more alive
alkaline	more alkaline
alleged	more alleged
allied	more allied
allocated	more allocated
allotted	more allotted
alloyed	more alloyed
alluring	more alluring
alluvial	more alluvial
alone	more alone
aloof	more aloof
altering	more altering
altruistic	more altruistic
amazing	more amazing
amber	more amber
ambiguous	more ambiguous
ambitious	more ambitious
ambling	more ambling
amended	more amended
amiable	more amiable
amicable	more amicable
amoral	more amoral
amorous	more amorous
amorphous	more amorphous
amplified	more amplified
amplifying	more amplifying
amputated	more amputated
amusing	more amusing
anachronistic	more anachronistic
anal	more anal
analog	more analog
analogue	more analogue
analytical	more analytical
analyzed	more analyzed
analyzing	more analyzing
anchored	more anchored
anchoring	more anchoring
angelic	more angelic
angered	more angered
angled	more angled
angling	more angling
anguished	more anguished
angular	more angular
animated	more animated
annealing	more annealing
annexed	more annexed
annotated	more annotated
announcing	more announcing
annoying	more annoying
anointed	more anointed
anomalous	more anomalous
anonymous	more anonymous
anorexic	more anorexic
answered	more answered
anticipated	more anticipated
anticipating	more anticipating
antiquated	more antiquated
antique	more antique
antiseptic	more antiseptic
antisocial	more antisocial
anxious	more anxious
apathetic	more apathetic
apologetic	more apologetic
appalling	more appalling
apparent	more apparent
appealed	more appealed
appealing	more appealing
appeased	more appeased
appended	more appended
appetizing	more appetizing
applicable	more applicable
applied	more applied
applying	more applying
appointed	more appointed
appraising	more appraising
appreciated	more appreciated
appreciating	more appreciating
appreciative	more appreciative
approachable	more approachable
approved	more approved
aquatic	more aquatic
arbitrary	more arbitrary
arcane	more arcane
archaic	more archaic
arched	more arched
arching	more arching
architectural	more architectural
archived	more archived
archiving	more archiving
arcing	more arcing
ardent	more ardent
arduous	more arduous
arguing	more arguing
arid	more arid
aristocratic	more aristocratic
armed	more armed
armored	more armored
armoured	more armoured
aromatic	more aromatic
aroused	more aroused
arousing	more arousing
arpeggiated	more arpeggiated
arranged	more arranged
arrayed	more arrayed
arrested	more arrested
arresting	more arresting
arrogant	more arrogant
artful	more artful
articulate	more articulate
articulated	more articulated
artificial	more artificial
artistic	more artistic
artless	more artless
ascending	more ascending
aspiring	more aspiring
assaulted	more assaulted
assaulting	more assaulting
assembled	more assembled
assembling	more assembling
asserted	more asserted
assertive	more assertive
assessed	more assessed
assessing	more assessing
asset	more asset
assiduous	more assiduous
assigned	more assigned
assisting	more assisting
assumed	more assumed
assured	more assured
astonishing	more astonishing
astounding	more astounding
astute	more astute
athletic	more athletic
atmospheric	more atmospheric
atomized	more atomized
atrophied	more atrophied
attached	more attached
attaching	more attaching
attacked	more attacked
attacking	more attacking
attained	more attained
attended	more attended
attending	more attending
attentive	more attentive
attenuated	more attenuated
attenuating	more attenuating
attracting	more attracting
attractive	more attractive
audacious	more audacious
audible	more audible
auditing	more auditing
auditioning	more auditioning
august	more august
auspicious	more auspicious
austere	more austere
authentic	more authentic
authenticated	more authenticated
authoring	more authoring
authoritarian	more authoritarian
authoritative	more authoritative
authorized	more authorized
authorizing	more authorizing
autographed	more autographed
automated	more automated
automatic	more automatic
autonomous	more autonomous
avid	more avid
avowed	more avowed
awakening	more awakening
awarded	more awarded
aware	more aware
awed	more awed
awkward	more awkward
babbling	more babbling
babysitting	more babysitting
backbiting	more backbiting
backbreaking	more backbreaking
backfiring	more backfiring
backhanded	more backhanded
backing	more backing
backpacking	more backpacking
backsliding	more backsliding
backstabbing	more backstabbing
baffled	more baffled
baffling	more baffling
baited	more baited
baiting	more baiting
baked	more baked
baking	more baking
balanced	more balanced
balancing	more balancing
balding	more balding
banal	more banal
banded	more banded
banding	more banding
banged	more banged
banging	more banging
banked	more banked
banking	more banking
banned	more banned
banning	more banning
baptized	more baptized
barbaric	more barbaric
barbarous	more barbarous
barbecued	more barbecued
barbed	more barbed
barefaced	more barefaced
bargaining	more bargaining
barking	more barking
barred	more barred
barren	more barren
bashful	more bashful
basic	more basic
basking	more basking
bated	more bated
batted	more batted
battered	more battered
battering	more battering
batting	more batting
battling	more battling
bawling	more bawling
beached	more beached
beaded	more beaded
beamed	more beamed
beaming	more beaming
bearded	more bearded
bearing	more bearing
beaten	more beaten
beating	more beating
beautifying	more beautifying
beckoning	more beckoning
bedraggled	more bedraggled
beeping	more beeping
befuddled	more befuddled
begging	more begging
beginning	more beginning
beguiling	more beguiling
bejeweled	more bejeweled
belching	more belching
believable	more believable
believed	more believed
believing	more believing
belligerent	more belligerent
bellowing	more bellowing
beloved	more beloved
belting	more belting
benchmarking	more benchmarking
bendable	more bendable
bended	more bended
bending	more bending
beneficial	more beneficial
benevolent	more benevolent
benign	more benign
bent	more bent
bereaved	more bereaved
bereft	more bereft
besieged	more besieged
besotted	more besotted
bestselling	more bestselling
betrayed	more betrayed
betraying	more betraying
betting	more betting
beveled	more beveled
bewildered	more bewildered
bewildering	more bewildering
bewitching	more bewitching
biased	more biased
biasing	more biasing
bickering	more bickering
biddable	more biddable
bidding	more bidding
bigoted	more bigoted
billed	more billed
billing	more billing
billowing	more billowing
billowy	more billowy
binding	more binding
biological	more biological
birthing	more birthing
bitching	more bitching
biting	more biting
bizarre	more bizarre
blabbering	more blabbering
blackened	more blackened
bladed	more bladed
blamed	more blamed
blameless	more blameless
blanched	more blanched
blaring	more blaring
blasphemous	more blasphemous
blasted	more blasted
blasting	more blasting
blatant	more blatant
blathering	more blathering
blazing	more blazing
bleached	more bleached
bleaching	more bleaching
bleating	more bleating
bleeding	more bleeding
blemished	more blemished
blended	more blended
blending	more blending
blessed	more blessed
blessing	more blessing
blighted	more blighted
blinded	more blinded
blindfolded	more blindfolded
blinding	more blinding
blinking	more blinking
blistered	more blistered
blistering	more blistering
blithering	more blithering
blitzing	more blitzing
bloated	more bloated
blocked	more blocked
blocking	more blocking
blogged	more blogged
blogging	more blogging
blonde	more blonde
bloodcurdling	more bloodcurdling
bloodied	more bloodied
bloodless	more bloodless
bloodsucking	more bloodsucking
bloodthirsty	more bloodthirsty
blooming	more blooming
blossomed	more blossomed
blossoming	more blossoming
blotting	more blotting
blowing	more blowing
blubbering	more blubbering
bluffing	more bluffing
blundering	more blundering
blurred	more blurred
blushing	more blushing
blustering	more blustering
blustery	more blustery
boasting	more boasting
boating	more boating
bobbing	more bobbing
bodybuilding	more bodybuilding
bogus	more bogus
bohemian	more bohemian
boiled	more boiled
boiling	more boiling
boisterous	more boisterous
bolted	more bolted
bolting	more bolting
bombing	more bombing
bonded	more bonded
bonding	more bonding
boned	more boned
boneless	more boneless
booked	more booked
booking	more booking
bookmarked	more bookmarked
booming	more booming
boosted	more boosted
boosting	more boosting
bootlegging	more bootlegging
bordering	more bordering
borrowed	more borrowed
borrowing	more borrowing
botched	more botched
bothersome	more bothersome
bottled	more bottled
bottling	more bottling
bottomless	more bottomless
bought	more bought
bounced	more bounced
bouncing	more bouncing
bound	more bound
bounded	more bounded
boundless	more boundless
bountiful	more bountiful
bovine	more bovine
bowed	more bowed
bowing	more bowing
bowled	more bowled
bowling	more bowling
boxed	more boxed
braced	more braced
bracing	more bracing
bragging	more bragging
braided	more braided
brainless	more brainless
brainstorming	more brainstorming
brainwashed	more brainwashed
brainwashing	more brainwashing
braking	more braking
branched	more branched
branching	more branching
branded	more branded
branding	more branding
braved	more braved
brawling	more brawling
braying	more braying
brazen	more brazen
breached	more breached
breaching	more breaching
breakable	more breakable
breaking	more breaking
breastfeeding	more breastfeeding
breathed	more breathed
breathing	more breathing
breathless	more breathless
breathtaking	more breathtaking
breeding	more breeding
brewed	more brewed
brewing	more brewing
bridled	more bridled
briefing	more briefing
brightening	more brightening
brimming	more brimming
briny	more briny
bristling	more bristling
bristly	more bristly
broadcasted	more broadcasted
broadcasting	more broadcasting
broadening	more broadening
broadminded	more broadminded
broiled	more broiled
broken	more broken
bronzed	more bronzed
brooding	more brooding
browned	more browned
browsing	more browsing
bruised	more bruised
brushed	more brushed
brusque	more brusque
brutal	more brutal
brutalized	more brutalized
brutalizing	more brutalizing
brutish	more brutish
bubbling	more bubbling
bucking	more bucking
buckled	more buckled
budding	more budding
buffed	more buffed
buffered	more buffered
buffering	more buffering
buffeting	more buffeting
buffing	more buffing
building	more building
built	more built
bulging	more bulging
bulleted	more bulleted
bullied	more bullied
bullying	more bullying
bumbling	more bumbling
bumping	more bumping
bumptious	more bumptious
bunched	more bunched
bundled	more bundled
bundling	more bundling
bungling	more bungling
buoyant	more buoyant
burdened	more burdened
burdening	more burdening
burdensome	more burdensome
bureaucratic	more bureaucratic
burgeoning	more burgeoning
buried	more buried
burned	more burned
burning	more burning
burnished	more burnished
burnt	more burnt
burrowing	more burrowing
burst	more burst
bursting	more bursting
busted	more busted
busting	more busting
bustling	more bustling
butchered	more butchered
butchering	more butchering
buttered	more buttered
buttery	more buttery
buttoned	more buttoned
buxom	more buxom
buying	more buying
buzzing	more buzzing
bypassing	more bypassing
cabled	more cabled
caching	more caching
cackling	more cackling
cacophonous	more cacophonous
cadaverous	more cadaverous
caffeinated	more caffeinated
caged	more caged
cajoling	more cajoling
calcified	more calcified
calculated	more calculated
calculating	more calculating
calculative	more calculative
calibrated	more calibrated
callous	more callous
calloused	more calloused
callused	more callused
calming	more calming
calving	more calving
cambered	more cambered
camouflaged	more camouflaged
campaigning	more campaigning
camping	more camping
cancelled	more cancelled
candid	more candid
candied	more candied
caning	more caning
canned	more canned
canning	more canning
canoeing	more canoeing
canonized	more canonized
cantankerous	more cantankerous
cantering	more cantering
canting	more canting
capable	more capable
capacious	more capacious
capitalistic	more capitalistic
capitalized	more capitalized
capped	more capped
capping	more capping
capricious	more capricious
captivating	more captivating
captured	more captured
capturing	more capturing
caramelized	more caramelized
carbonated	more carbonated
carding	more carding
carefree	more carefree
careful	more careful
careless	more careless
caressing	more caressing
caricatured	more caricatured
caring	more caring
carnivorous	more carnivorous
caroling	more caroling
carousing	more carousing
carpeted	more carpeted
carpeting	more carpeting
carried	more carried
carrying	more carrying
carved	more carved
carving	more carving
cascaded	more cascaded
cascading	more cascading
cashed	more cashed
cashing	more cashing
casing	more casing
casting	more casting
castrated	more castrated
casual	more casual
cataloging	more cataloging
catalogued	more catalogued
catastrophic	more catastrophic
catching	more catching
categorized	more categorized
catered	more catered
catering	more catering
cautious	more cautious
cavorting	more cavorting
celebrated	more celebrated
celebrating	more celebrating
celibate	more celibate
cemented	more cemented
cementing	more cementing
censoring	more censoring
centered	more centered
central	more central
centralized	more centralized
centralizing	more centralizing
cerebral	more cerebral
certified	more certified
certifying	more certifying
chafed	more chafed
chained	more chained
challenged	more challenged
challenging	more challenging
changeable	more changeable
changeful	more changeful
changing	more changing
channeled	more channeled
channelized	more channelized
chanted	more chanted
chanting	more chanting
chaotic	more chaotic
chapped	more chapped
characteristic	more characteristic
charged	more charged
charging	more charging
charismatic	more charismatic
charitable	more charitable
charmed	more charmed
charming	more charming
charred	more charred
charted	more charted
chartered	more chartered
charting	more charting
chased	more chased
chasing	more chasing
chastened	more chastened
chastening	more chastening
chastised	more chastised
chastising	more chastising
chattering	more chattering
chatting	more chatting
cheated	more cheated
cheating	more cheating
checkered	more checkered
checking	more checking
cheering	more cheering
cheerless	more cheerless
chequered	more chequered
cherished	more cherished
chesty	more chesty
chewed	more chewed
chewing	more chewing
childish	more childish
chilled	more chilled
chilling	more chilling
chiming	more chiming
chipped	more chipped
chipper	more chipper
chipping	more chipping
chirping	more chirping
chiseled	more chiseled
chiseling	more chiseling
chivalrous	more chivalrous
chlorinated	more chlorinated
choked	more choked
choking	more choking
chomping	more chomping
choosing	more choosing
chopped	more chopped
chopping	more chopping
choreographed	more choreographed
chronic	more chronic
chuffed	more chuffed
chugging	more chugging
churlish	more churlish
churned	more churned
churning	more churning
circling	more circling
circuitous	more circuitous
circular	more circular
circulated	more circulated
circulating	more circulating
circumspect	more circumspect
cited	more cited
civilized	more civilized
cladding	more cladding
clamoring	more clamoring
clamped	more clamped
clamping	more clamping
clandestine	more clandestine
clanging	more clanging
clanking	more clanking
clapping	more clapping
clarified	more clarified
clarion	more clarion
clashing	more clashing
classic	more classic
classical	more classical
classified	more classified
clattering	more clattering
claustrophobic	more claustrophobic
cleaning	more cleaning
cleansing	more cleansing
clearcut	more clearcut
clearing	more clearing
clenched	more clenched
cliched	more cliched
clich?d	more clich?d
clicked	more clicked
clicking	more clicking
climactic	more climactic
climbed	more climbed
climbing	more climbing
clinging	more clinging
clinical	more clinical
clipped	more clipped
clipping	more clipping
cloaked	more cloaked
clogged	more clogged
clogging	more clogging
cloistered	more cloistered
cloned	more cloned
closed	more closed
clotted	more clotted
clotting	more clotting
clouded	more clouded
clowning	more clowning
clubbing	more clubbing
clucking	more clucking
clueless	more clueless
clumping	more clumping
clustering	more clustering
clutching	more clutching
cluttered	more cluttered
coached	more coached
coaching	more coaching
coated	more coated
coating	more coating
cobbled	more cobbled
coddled	more coddled
coded	more coded
codified	more codified
coding	more coding
coercive	more coercive
coherent	more coherent
cohesive	more cohesive
coiled	more coiled
coldblooded	more coldblooded
collaborating	more collaborating
collaborative	more collaborative
collapsed	more collapsed
collapsing	more collapsing
collared	more collared
collating	more collating
collectable	more collectable
collected	more collected
collectible	more collectible
collecting	more collecting
collectivized	more collectivized
colliding	more colliding
collimated	more collimated
colonized	more colonized
colored	more colored
colorful	more colorful
coloring	more coloring
colorless	more colorless
colossal	more colossal
colourful	more colourful
colourless	more colourless
combed	more combed
combined	more combined
combing	more combing
combining	more combining
combustible	more combustible
comfortable	more comfortable
comforting	more comforting
comic	more comic
commanded	more commanded
commanding	more commanding
commemorated	more commemorated
commendable	more commendable
commended	more commended
commenting	more commenting
commercial	more commercial
commissioned	more commissioned
commissioning	more commissioning
committed	more committed
commodious	more commodious
commoditized	more commoditized
commonplace	more commonplace
communal	more communal
communicated	more communicated
communicating	more communicating
communicative	more communicative
commuting	more commuting
companionable	more companionable
compassionate	more compassionate
compelling	more compelling
compendious	more compendious
compensated	more compensated
competent	more competent
competing	more competing
competitive	more competitive
compiled	more compiled
compiling	more compiling
complacent	more complacent
complaining	more complaining
completed	more completed
compliant	more compliant
complicated	more complicated
complying	more complying
composed	more composed
composing	more composing
compositing	more compositing
composted	more composted
comprehensive	more comprehensive
compressed	more compressed
compressible	more compressible
compressing	more compressing
compromising	more compromising
compulsive	more compulsive
computed	more computed
computerised	more computerised
computerized	more computerized
computing	more computing
concatenated	more concatenated
concave	more concave
concealed	more concealed
concealing	more concealing
conceited	more conceited
conceived	more conceived
concentrated	more concentrated
concerned	more concerned
concerning	more concerning
concise	more concise
concluded	more concluded
concluding	more concluding
conclusive	more conclusive
concocted	more concocted
concrete	more concrete
condemned	more condemned
condemning	more condemning
condensed	more condensed
condensing	more condensing
condescending	more condescending
conditioned	more conditioned
conditioning	more conditioning
condoned	more condoned
conducted	more conducted
conducting	more conducting
conductive	more conductive
confessed	more confessed
confessing	more confessing
confident	more confident
confidential	more confidential
confiding	more confiding
configured	more configured
configuring	more configuring
confined	more confined
confining	more confining
confirmed	more confirmed
confiscated	more confiscated
conflicting	more conflicting
confounded	more confounded
confounding	more confounding
confrontational	more confrontational
confused	more confused
confusing	more confusing
congealed	more congealed
congenial	more congenial
congested	more congested
congratulatory	more congratulatory
conjuring	more conjuring
connected	more connected
connecting	more connecting
conniving	more conniving
conquered	more conquered
conquering	more conquering
conscientious	more conscientious
conscious	more conscious
consecrated	more consecrated
conservative	more conservative
considerable	more considerable
considerate	more considerate
considered	more considered
considering	more considering
consistent	more consistent
consolidated	more consolidated
consolidating	more consolidating
conspicuous	more conspicuous
conspiring	more conspiring
constant	more constant
constipated	more constipated
constrained	more constrained
constraining	more constraining
constricted	more constricted
constricting	more constricting
constrictive	more constrictive
constructed	more constructed
constructing	more constructing
constructive	more constructive
consultative	more consultative
consulted	more consulted
consulting	more consulting
consuming	more consuming
contagious	more contagious
contaminated	more contaminated
contaminating	more contaminating
contemplated	more contemplated
contemplative	more contemplative
contemporary	more contemporary
contemptible	more contemptible
contending	more contending
content	more content
contented	more contented
contentious	more contentious
contested	more contested
contesting	more contesting
continuing	more continuing
continuous	more continuous
contoured	more contoured
contracted	more contracted
contracting	more contracting
contradictory	more contradictory
contrary	more contrary
contributing	more contributing
contrived	more contrived
controllable	more controllable
controlled	more controlled
controlling	more controlling
convened	more convened
convenient	more convenient
conventional	more conventional
conventionalized	more conventionalized
conversational	more conversational
converted	more converted
converting	more converting
conveying	more conveying
convicted	more convicted
convincing	more convincing
convoluted	more convoluted
cooing	more cooing
cooked	more cooked
cooking	more cooking
cooled	more cooled
cooling	more cooling
cooped	more cooped
cooperating	more cooperating
cooperative	more cooperative
coordinated	more coordinated
coordinating	more coordinating
copied	more copied
copying	more copying
copyrighted	more copyrighted
corded	more corded
cordial	more cordial
coring	more coring
corked	more corked
cornered	more cornered
corporate	more corporate
corrected	more corrected
correcting	more correcting
corroborated	more corroborated
corroded	more corroded
corroding	more corroding
corrosive	more corrosive
corrugated	more corrugated
corrupt	more corrupt
corrupted	more corrupted
corrupting	more corrupting
cosmopolitan	more cosmopolitan
costumed	more costumed
coughing	more coughing
counseling	more counseling
counterbalanced	more counterbalanced
counterfeiting	more counterfeiting
counting	more counting
coupling	more coupling
courageous	more courageous
coursing	more coursing
courteous	more courteous
courtly	more courtly
covering	more covering
coveted	more coveted
covetous	more covetous
cowardly	more cowardly
cowed	more cowed
cowering	more cowering
cracked	more cracked
cracking	more cracking
crackling	more crackling
cradling	more cradling
crafted	more crafted
crafting	more crafting
crammed	more crammed
cramped	more cramped
cranked	more cranked
cranking	more cranking
crashed	more crashed
crashing	more crashing
cratered	more cratered
crawling	more crawling
crazed	more crazed
creaking	more creaking
creamed	more creamed
creased	more creased
created	more created
creating	more creating
creative	more creative
credentialed	more credentialed
credible	more credible
credited	more credited
creeping	more creeping
crested	more crested
crestfallen	more crestfallen
cricketing	more cricketing
criminal	more criminal
criminalized	more criminalized
crimping	more crimping
crimson	more crimson
cringing	more cringing
crinkled	more crinkled
crippled	more crippled
crippling	more crippling
critical	more critical
criticizing	more criticizing
critiquing	more critiquing
crocheted	more crocheted
crocheting	more crocheting
crooning	more crooning
cropped	more cropped
cropping	more cropping
crossbred	more crossbred
crossing	more crossing
crouching	more crouching
crowded	more crowded
crowing	more crowing
crowned	more crowned
crowning	more crowning
crucial	more crucial
crucified	more crucified
cruising	more cruising
crumbled	more crumbled
crumbling	more crumbling
crumpled	more crumpled
crunching	more crunching
crusading	more crusading
crushed	more crushed
crushing	more crushing
crying	more crying
crystalized	more crystalized
crystallized	more crystallized
cubed	more cubed
cuddling	more cuddling
culled	more culled
culpable	more culpable
cultivated	more cultivated
cultivating	more cultivating
cultural	more cultural
cultured	more cultured
cumbersome	more cumbersome
cupped	more cupped
curated	more curated
cured	more cured
curing	more curing
curled	more curled
curling	more curling
current	more current
cursed	more cursed
cursing	more cursing
curved	more curved
cushioned	more cushioned
cushioning	more cushioning
cussing	more cussing
customized	more customized
cute	cuter
cutthroat	more cutthroat
cutting	more cutting
cyclical	more cyclical
cycling	more cycling
cynical	more cynical
dabbling	more dabbling
damaging	more damaging
dammed	more dammed
damming	more damming
damned	more damned
damning	more damning
damped	more damped
dampened	more dampened
dampening	more dampening
damping	more damping
dancing	more dancing
dandy	more dandy
dangerous	more dangerous
dangling	more dangling
dappled	more dappled
daring	more daring
darkened	more darkened
darkening	more darkening
darned	more darned
darting	more darting
dashed	more dashed
dashing	more dashing
dated	more dated
dating	more dating
daunting	more daunting
dawning	more dawning
daydreaming	more daydreaming
dazed	more dazed
dazzling	more dazzling
deactivated	more deactivated
deafening	more deafening
dealing	more dealing
dealmaking	more dealmaking
dealt	more dealt
debased	more debased
debauched	more debauched
debilitating	more debilitating
debonair	more debonair
debugged	more debugged
debugging	more debugging
debunking	more debunking
decadent	more decadent
decapitated	more decapitated
decayed	more decayed
decaying	more decaying
deceased	more deceased
deceitful	more deceitful
deceived	more deceived
deceiving	more deceiving
decentralized	more decentralized
deceptive	more deceptive
decided	more decided
deciding	more deciding
decisive	more decisive
decked	more decked
declarative	more declarative
declared	more declared
declined	more declined
decoded	more decoded
decoding	more decoding
decomposed	more decomposed
decomposing	more decomposing
decorated	more decorated
decorating	more decorating
decorative	more decorative
decorous	more decorous
decrepit	more decrepit
dedicated	more dedicated
deepening	more deepening
defaulting	more defaulting
defeated	more defeated
defeating	more defeating
defended	more defended
defending	more defending
defenseless	more defenseless
defensible	more defensible
defensive	more defensive
deferred	more deferred
defiant	more defiant
defiling	more defiling
defined	more defined
defining	more defining
definite	more definite
definitive	more definitive
deflated	more deflated
deflating	more deflating
deflected	more deflected
deformed	more deformed
deforming	more deforming
defrosting	more defrosting
defused	more defused
degraded	more degraded
degrading	more degrading
dehumanizing	more dehumanizing
dehydrated	more dehydrated
deified	more deified
delayed	more delayed
delaying	more delaying
delectable	more delectable
delegating	more delegating
deliberate	more deliberate
delicate	more delicate
delicious	more delicious
delighted	more delighted
delightful	more delightful
delighting	more delighting
delivered	more delivered
delivering	more delivering
delocalized	more delocalized
deluded	more deluded
delusional	more delusional
demanding	more demanding
demeaning	more demeaning
demented	more demented
democratic	more democratic
demolished	more demolished
demonic	more demonic
demonstrated	more demonstrated
demonstrating	more demonstrating
demonstrative	more demonstrative
demoralized	more demoralized
demoralizing	more demoralizing
demotivating	more demotivating
demure	more demure
denounced	more denounced
dented	more dented
denuded	more denuded
departed	more departed
dependable	more dependable
dependent	more dependent
depicting	more depicting
depleted	more depleted
deployed	more deployed
deploying	more deploying
depopulated	more depopulated
deported	more deported
deposited	more deposited
depraved	more depraved
depreciating	more depreciating
depressed	more depressed
depressing	more depressing
deprived	more deprived
derailed	more derailed
deranged	more deranged
deregulated	more deregulated
derived	more derived
desaturated	more desaturated
descended	more descended
descending	more descending
describing	more describing
descriptive	more descriptive
deserted	more deserted
deserved	more deserved
deserving	more deserving
desiccated	more desiccated
designated	more designated
designed	more designed
designing	more designing
desirable	more desirable
desired	more desired
desolate	more desolate
desolated	more desolated
despairing	more despairing
desperate	more desperate
despicable	more despicable
despised	more despised
destabilizing	more destabilizing
destitute	more destitute
destroying	more destroying
destructive	more destructive
detached	more detached
detailed	more detailed
detained	more detained
detected	more detected
detecting	more detecting
deteriorating	more deteriorating
determinate	more determinate
determined	more determined
deterministic	more deterministic
deterring	more deterring
detestable	more detestable
detoxifying	more detoxifying
detrimental	more detrimental
devalued	more devalued
devastated	more devastated
devastating	more devastating
developed	more developed
developing	more developing
developmental	more developmental
deviating	more deviating
devious	more devious
devised	more devised
devoted	more devoted
devouring	more devouring
devout	more devout
dexterous	more dexterous
diabolical	more diabolical
diagnosed	more diagnosed
diagnosing	more diagnosing
dialed	more dialed
dialing	more dialing
diaphanous	more diaphanous
diced	more diced
dicey	more dicey
dicing	more dicing
dictated	more dictated
dictating	more dictating
dictatorial	more dictatorial
diecast	more diecast
dieting	more dieting
difficult	more difficult
diffused	more diffused
diffusing	more diffusing
digesting	more digesting
digging	more digging
digitized	more digitized
digitizing	more digitizing
dignified	more dignified
dilapidated	more dilapidated
dilated	more dilated
diligent	more diligent
dilute	more dilute
diluted	more diluted
diminishing	more diminishing
dimmed	more dimmed
dimming	more dimming
dimpled	more dimpled
dimwitted	more dimwitted
diplomatic	more diplomatic
dipped	more dipped
dipping	more dipping
direct	more direct
directed	more directed
directing	more directing
directional	more directional
disabled	more disabled
disabling	more disabling
disadvantaged	more disadvantaged
disaffected	more disaffected
disagreeable	more disagreeable
disappearing	more disappearing
disappointed	more disappointed
disappointing	more disappointing
disapproving	more disapproving
disarmed	more disarmed
disarming	more disarming
disastrous	more disastrous
discarded	more discarded
discernible	more discernible
discerning	more discerning
discharged	more discharged
discharging	more discharging
disciplined	more disciplined
disciplining	more disciplining
disconcerting	more disconcerting
disconsolate	more disconsolate
discontented	more discontented
discontinued	more discontinued
discontinuous	more discontinuous
discounted	more discounted
discounting	more discounting
discouraged	more discouraged
discouraging	more discouraging
discovered	more discovered
discovering	more discovering
discredited	more discredited
discreet	more discreet
discriminating	more discriminating
discussing	more discussing
diseased	more diseased
disembodied	more disembodied
disenfranchised	more disenfranchised
disengaged	more disengaged
disfigured	more disfigured
disfiguring	more disfiguring
disgraced	more disgraced
disgraceful	more disgraceful
disgruntled	more disgruntled
disguised	more disguised
disguising	more disguising
disgusted	more disgusted
disgusting	more disgusting
disheartening	more disheartening
disheveled	more disheveled
dishonest	more dishonest
disillusioned	more disillusioned
disinfecting	more disinfecting
disingenuous	more disingenuous
disintegrating	more disintegrating
disinterested	more disinterested
disjointed	more disjointed
dislocated	more dislocated
dismal	more dismal
dismantled	more dismantled
dismembered	more dismembered
dismissed	more dismissed
dismissing	more dismissing
dismissive	more dismissive
dismounted	more dismounted
disordered	more disordered
disorderly	more disorderly
disorganised	more disorganised
disorganized	more disorganized
disoriented	more disoriented
disorienting	more disorienting
disparaging	more disparaging
dispassionate	more dispassionate
dispatched	more dispatched
dispatching	more dispatching
dispelling	more dispelling
dispensable	more dispensable
dispensed	more dispensed
dispensing	more dispensing
dispersed	more dispersed
dispersing	more dispersing
displayed	more displayed
displaying	more displaying
disposable	more disposable
dispossessed	more dispossessed
disputed	more disputed
disqualified	more disqualified
disquieting	more disquieting
disreputable	more disreputable
disrespectful	more disrespectful
disrupting	more disrupting
disruptive	more disruptive
dissected	more dissected
dissecting	more dissecting
disseminated	more disseminated
dissenting	more dissenting
dissing	more dissing
dissolved	more dissolved
dissolving	more dissolving
distant	more distant
distasteful	more distasteful
distilled	more distilled
distinct	more distinct
distinctive	more distinctive
distinguishable	more distinguishable
distinguished	more distinguished
distinguishing	more distinguishing
distorted	more distorted
distorting	more distorting
distracted	more distracted
distracting	more distracting
distressed	more distressed
distressing	more distressing
distributed	more distributed
distributing	more distributing
disturbed	more disturbed
disturbing	more disturbing
dithering	more dithering
divergent	more divergent
diversified	more diversified
diversifying	more diversifying
diverted	more diverted
diverting	more diverting
divided	more divided
dividing	more dividing
diving	more diving
divisive	more divisive
divorced	more divorced
dizzying	more dizzying
docile	more docile
docked	more docked
docking	more docking
doctored	more doctored
documented	more documented
documenting	more documenting
dogged	more dogged
dogging	more dogging
dogmatic	more dogmatic
domed	more domed
domestic	more domestic
domesticated	more domesticated
dominant	more dominant
dominating	more dominating
domineering	more domineering
donated	more donated
donating	more donating
donned	more donned
doomed	more doomed
dormant	more dormant
doting	more doting
dotted	more dotted
doubting	more doubting
dour	more dour
downloaded	more downloaded
downy	more downy
dozing	more dozing
drafted	more drafted
drafting	more drafting
dragged	more dragged
dragging	more dragging
drained	more drained
draining	more draining
dramatic	more dramatic
dramatized	more dramatized
draped	more draped
draping	more draping
drastic	more drastic
drawing	more drawing
drawn	more drawn
dreaded	more dreaded
dreadful	more dreadful
dreaming	more dreaming
dredging	more dredging
drenched	more drenched
drenching	more drenching
dressed	more dressed
dressing	more dressing
dribbled	more dribbled
dribbling	more dribbling
dried	more dried
drifting	more drifting
drilled	more drilled
drilling	more drilling
drinking	more drinking
dripping	more dripping
drippy	more drippy
driven	more driven
driving	more driving
droning	more droning
drooling	more drooling
drooping	more drooping
dropped	more dropped
dropping	more dropping
drowned	more drowned
drowning	more drowning
drumming	more drumming
drunken	more drunken
drying	more drying
dubbed	more dubbed
ductile	more ductile
dulled	more dulled
dumped	more dumped
dumping	more dumping
duped	more duped
duplicating	more duplicating
duplicitous	more duplicitous
durable	more durable
dusted	more dusted
dusting	more dusting
dutiful	more dutiful
dwelling	more dwelling
dwindling	more dwindling
dyed	more dyed
dying	more dying
dynamic	more dynamic
dysfunctional	more dysfunctional
dyslexic	more dyslexic
eager	more eager
earned	more earned
earnest	more earnest
earning	more earning
earthed	more earthed
eased	more eased
easygoing	more easygoing
eating	more eating
eavesdropping	more eavesdropping
ebullient	more ebullient
eccentric	more eccentric
echoing	more echoing
eclectic	more eclectic
eclipsed	more eclipsed
edged	more edged
edible	more edible
edited	more edited
editorializing	more editorializing
educated	more educated
educating	more educating
educational	more educational
eerie	more eerie
effective	more effective
effectual	more effectual
effervescent	more effervescent
efficacious	more efficacious
efficient	more efficient
effortless	more effortless
effusive	more effusive
egalitarian	more egalitarian
egocentric	more egocentric
egotistical	more egotistical
elaborate	more elaborate
elastic	more elastic
elasticized	more elasticized
elected	more elected
electric	more electric
electrified	more electrified
electrifying	more electrifying
elegant	more elegant
elementary	more elementary
elevated	more elevated
elicited	more elicited
eliminated	more eliminated
eliminating	more eliminating
elite	more elite
elitist	more elitist
elliptical	more elliptical
elongated	more elongated
eloquent	more eloquent
elusive	more elusive
emaciated	more emaciated
emailed	more emailed
emancipated	more emancipated
embarrassed	more embarrassed
embarrassing	more embarrassing
embattled	more embattled
embedded	more embedded
embellished	more embellished
embellishing	more embellishing
embittered	more embittered
emblazoned	more emblazoned
embodied	more embodied
emboldened	more emboldened
embossed	more embossed
embroidered	more embroidered
emerging	more emerging
eminent	more eminent
emitted	more emitted
emitting	more emitting
emoting	more emoting
emotional	more emotional
emotionless	more emotionless
emphasizing	more emphasizing
emphatic	more emphatic
employed	more employed
employing	more employing
empowered	more empowered
empowering	more empowering
emptied	more emptied
emptying	more emptying
emulating	more emulating
enabling	more enabling
enacted	more enacted
encamped	more encamped
encased	more encased
enchanted	more enchanted
enchanting	more enchanting
encircled	more encircled
enclosed	more enclosed
enclosing	more enclosing
encoded	more encoded
encoding	more encoding
encompassing	more encompassing
encouraging	more encouraging
encroaching	more encroaching
encrusted	more encrusted
encrypted	more encrypted
encumbering	more encumbering
endangered	more endangered
endangering	more endangering
endearing	more endearing
endorsed	more endorsed
endorsing	more endorsing
endowed	more endowed
endurable	more endurable
enduring	more enduring
energetic	more energetic
energized	more energized
energizing	more energizing
enforceable	more enforceable
enforced	more enforced
enforcing	more enforcing
engaging	more engaging
engineered	more engineered
engineering	more engineering
engorged	more engorged
engraved	more engraved
engraving	more engraving
engrossing	more engrossing
engulfing	more engulfing
enhanced	more enhanced
enhancing	more enhancing
enigmatic	more enigmatic
enjoyable	more enjoyable
enjoyed	more enjoyed
enjoying	more enjoying
enlarged	more enlarged
enlarging	more enlarging
enlightened	more enlightened
enlightening	more enlightening
enlisted	more enlisted
ennobled	more ennobled
enormous	more enormous
enraged	more enraged
enriched	more enriched
enriching	more enriching
enrolled	more enrolled
enrolling	more enrolling
enslaved	more enslaved
enslaving	more enslaving
ensuing	more ensuing
entangled	more entangled
enterprising	more enterprising
entertained	more entertained
entertaining	more entertaining
enthralling	more enthralling
enthroned	more enthroned
enthused	more enthused
enthusiastic	more enthusiastic
enticing	more enticing
entrancing	more entrancing
entrenched	more entrenched
entwined	more entwined
enveloping	more enveloping
envisioning	more envisioning
ephemeral	more ephemeral
equipped	more equipped
equivocal	more equivocal
erased	more erased
erect	more erect
erected	more erected
eroded	more eroded
eroding	more eroding
erotic	more erotic
erratic	more erratic
erring	more erring
erudite	more erudite
erupted	more erupted
escalated	more escalated
escalating	more escalating
escaped	more escaped
escaping	more escaping
escorted	more escorted
esoteric	more esoteric
essential	more essential
established	more established
esteemed	more esteemed
estimated	more estimated
estimating	more estimating
estranged	more estranged
etched	more etched
etching	more etching
eternal	more eternal
ethereal	more ethereal
ethical	more ethical
euphoric	more euphoric
evacuated	more evacuated
evading	more evading
evaluated	more evaluated
evaluating	more evaluating
evanescent	more evanescent
evangelical	more evangelical
evangelizing	more evangelizing
evaporated	more evaporated
evaporative	more evaporative
evenhanded	more evenhanded
eventful	more eventful
everlasting	more everlasting
everyday	more everyday
evocative	more evocative
evolved	more evolved
evolving	more evolving
exact	more exact
exacting	more exacting
exaggerated	more exaggerated
exaggerating	more exaggerating
exalted	more exalted
exalting	more exalting
examined	more examined
examining	more examining
exasperated	more exasperated
exasperating	more exasperating
excavated	more excavated
excavating	more excavating
excelling	more excelling
exchanged	more exchanged
exchanging	more exchanging
excitable	more excitable
excited	more excited
exciting	more exciting
excluded	more excluded
exclusive	more exclusive
excreted	more excreted
excruciating	more excruciating
executed	more executed
executing	more executing
exempt	more exempt
exercised	more exercised
exfoliating	more exfoliating
exhaled	more exhaled
exhausted	more exhausted
exhausting	more exhausting
exhaustive	more exhaustive
exhibited	more exhibited
exhibiting	more exhibiting
exhilarating	more exhilarating
exiled	more exiled
exotic	more exotic
expanded	more expanded
expanding	more expanding
expansive	more expansive
expectant	more expectant
expected	more expected
expedient	more expedient
expedited	more expedited
expelled	more expelled
expendable	more expendable
expended	more expended
experienced	more experienced
experimental	more experimental
experimenting	more experimenting
expert	more expert
expired	more expired
explaining	more explaining
explicit	more explicit
exploded	more exploded
exploding	more exploding
exploited	more exploited
exploiting	more exploiting
explored	more explored
exploring	more exploring
explosive	more explosive
exported	more exported
exporting	more exporting
exposed	more exposed
exposing	more exposing
expressed	more expressed
expressing	more expressing
expressionless	more expressionless
expressive	more expressive
exquisite	more exquisite
extended	more extended
extending	more extending
extensive	more extensive
extinct	more extinct
extinguished	more extinguished
extracted	more extracted
extracting	more extracting
extraordinary	more extraordinary
extravagant	more extravagant
extraverted	more extraverted
extreme	more extreme
extruded	more extruded
exuberant	more exuberant
eying	more eying
fabled	more fabled
fabricated	more fabricated
faceless	more faceless
faceted	more faceted
facilitating	more facilitating
factfinding	more factfinding
factual	more factual
faddish	more faddish
faded	more faded
fading	more fading
failed	more failed
failing	more failing
faithful	more faithful
faked	more faked
faking	more faking
fallible	more fallible
falling	more falling
falsified	more falsified
faltering	more faltering
familiar	more familiar
famished	more famished
fanatic	more fanatic
fanned	more fanned
fanning	more fanning
fantastic	more fantastic
farfetched	more farfetched
farmed	more farmed
farming	more farming
farseeing	more farseeing
farsighted	more farsighted
farting	more farting
fascinated	more fascinated
fascinating	more fascinating
fashionable	more fashionable
fashioned	more fashioned
fastened	more fastened
fastening	more fastening
fastidious	more fastidious
fasting	more fasting
fatal	more fatal
fatalistic	more fatalistic
fatigued	more fatigued
fattened	more fattened
fattening	more fattening
faultless	more faultless
favored	more favored
fawning	more fawning
feared	more feared
fearful	more fearful
fearless	more fearless
fearsome	more fearsome
feasting	more feasting
feathered	more feathered
feathery	more feathery
featured	more featured
featureless	more featureless
feckless	more feckless
fecund	more fecund
feeding	more feeding
feeling	more feeling
feigned	more feigned
felicitous	more felicitous
felled	more felled
felling	more felling
felt	more felt
felted	more felted
female	more female
feminine	more feminine
fenced	more fenced
fencing	more fencing
feral	more feral
fermented	more fermented
fermenting	more fermenting
ferocious	more ferocious
fertile	more fertile
fertilized	more fertilized
fertilizing	more fertilizing
fervent	more fervent
festering	more festering
festive	more festive
fetching	more fetching
feted	more feted
fetid	more fetid
fettered	more fettered
feuding	more feuding
fevered	more fevered
fickle	more fickle
fictional	more fictional
fictionalized	more fictionalized
fiddling	more fiddling
fidgety	more fidgety
fielded	more fielded
fielding	more fielding
fighting	more fighting
filed	more filed
filibustering	more filibustering
filigreed	more filigreed
filing	more filing
filled	more filled
filleted	more filleted
filling	more filling
filmed	more filmed
filming	more filming
filmmaking	more filmmaking
filtered	more filtered
filtering	more filtering
financed	more financed
financing	more financing
finding	more finding
fingering	more fingering
fingerpicking	more fingerpicking
finicky	more finicky
finishing	more finishing
finite	more finite
firebombing	more firebombing
fired	more fired
firefighting	more firefighting
fireproof	more fireproof
firing	more firing
fishing	more fishing
fitted	more fitted
fitting	more fitting
fixed	more fixed
fixing	more fixing
fizzing	more fizzing
flaccid	more flaccid
flailing	more flailing
flakey	more flakey
flamboyant	more flamboyant
flaming	more flaming
flapping	more flapping
flared	more flared
flaring	more flaring
flashed	more flashed
flashing	more flashing
flatfooted	more flatfooted
flattened	more flattened
flattening	more flattening
flattering	more flattering
flavored	more flavored
flavorful	more flavorful
flavoring	more flavoring
flawed	more flawed
flawless	more flawless
fledged	more fledged
fleeing	more fleeing
fleeting	more fleeting
flexed	more flexed
flexible	more flexible
flickering	more flickering
flicking	more flicking
flinty	more flinty
flipped	more flipped
flirtatious	more flirtatious
flirting	more flirting
flitting	more flitting
floated	more floated
floating	more floating
flocked	more flocked
flocking	more flocking
flooded	more flooded
flooding	more flooding
flopping	more flopping
floundering	more floundering
flourishing	more flourishing
flowered	more flowered
flowering	more flowering
flowing	more flowing
fluctuating	more fluctuating
fluent	more fluent
fluffed	more fluffed
fluid	more fluid
flung	more flung
flushed	more flushed
flushing	more flushing
flustered	more flustered
fluted	more fluted
fluttering	more fluttering
flyfishing	more flyfishing
flying	more flying
foaming	more foaming
focused	more focused
focusing	more focusing
focussed	more focussed
fogged	more fogged
foiled	more foiled
foldable	more foldable
folded	more folded
folding	more folding
followed	more followed
following	more following
fooled	more fooled
fooling	more fooling
footballing	more footballing
foraging	more foraging
forbidden	more forbidden
forbidding	more forbidding
forced	more forced
forceful	more forceful
foreboding	more foreboding
forecasted	more forecasted
forecasting	more forecasting
foreclosed	more foreclosed
foreseeing	more foreseeing
forested	more forested
forged	more forged
forgetful	more forgetful
forgettable	more forgettable
forging	more forging
forgiving	more forgiving
forked	more forked
forking	more forking
forlorn	more forlorn
formal	more formal
formalized	more formalized
formative	more formative
formatted	more formatted
formidable	more formidable
formless	more formless
formulaic	more formulaic
formulated	more formulated
formulating	more formulating
fortified	more fortified
fortifying	more fortifying
fortunate	more fortunate
forwarded	more forwarded
fossilized	more fossilized
fostered	more fostered
fought	more fought
fouled	more fouled
founding	more founding
fractured	more fractured
fragile	more fragile
fragmented	more fragmented
fragrant	more fragrant
framed	more framed
franchised	more franchised
franked	more franked
frantic	more frantic
frayed	more frayed
fraying	more fraying
freckled	more freckled
freed	more freed
freeing	more freeing
freeloading	more freeloading
freestanding	more freestanding
freewheeling	more freewheeling
freezing	more freezing
frenzied	more frenzied
frequented	more frequented
freshening	more freshening
fretted	more fretted
fried	more fried
frightened	more frightened
frightening	more frightening
frigid	more frigid
fringed	more fringed
frivolous	more frivolous
frolicking	more frolicking
frolicsome	more frolicsome
frosted	more frosted
frosting	more frosting
frothing	more frothing
frowning	more frowning
frozen	more frozen
fruitful	more fruitful
fruitless	more fruitless
frustrated	more frustrated
frustrating	more frustrating
frying	more frying
fueled	more fueled
fueling	more fueling
fulfilled	more fulfilled
fulfilling	more fulfilling
fulminating	more fulminating
fumbling	more fumbling
functional	more functional
functioning	more functioning
funded	more funded
funding	more funding
fundraising	more fundraising
furious	more furious
furnished	more furnished
furnishing	more furnishing
furrowed	more furrowed
furtive	more furtive
fused	more fused
fusing	more fusing
fussing	more fussing
futile	more futile
gaga	more gaga
gained	more gained
gallant	more gallant
galling	more galling
galloping	more galloping
galvanized	more galvanized
gambling	more gambling
gaming	more gaming
gangly	more gangly
gaping	more gaping
gardening	more gardening
garnished	more garnished
garrisoned	more garrisoned
garrulous	more garrulous
gasping	more gasping
gated	more gated
gathering	more gathering
gating	more gating
gauging	more gauging
gawking	more gawking
gazing	more gazing
geared	more geared
gelled	more gelled
general	more general
generalized	more generalized
generalizing	more generalizing
generating	more generating
generous	more generous
genteel	more genteel
genuine	more genuine
geometric	more geometric
giant	more giant
gifted	more gifted
gigantic	more gigantic
giggling	more giggling
gilded	more gilded
ginger	more ginger
girlish	more girlish
giving	more giving
glaciated	more glaciated
glamorous	more glamorous
glaring	more glaring
glazed	more glazed
glazing	more glazing
gleaming	more gleaming
gleaning	more gleaning
gliding	more gliding
glistening	more glistening
glittering	more glittering
glorified	more glorified
glorifying	more glorifying
glorious	more glorious
glowing	more glowing
glued	more glued
gluttonous	more gluttonous
gnarled	more gnarled
gnawing	more gnawing
goading	more goading
gobbling	more gobbling
golden	more golden
golfing	more golfing
gooey	more gooey
gorgeous	more gorgeous
gorging	more gorging
gossiping	more gossiping
gossipy	more gossipy
gouging	more gouging
governed	more governed
governing	more governing
grabbing	more grabbing
graceful	more graceful
graceless	more graceless
gracious	more gracious
gradated	more gradated
graded	more graded
grading	more grading
gradual	more gradual
graduated	more graduated
graduating	more graduating
grafted	more grafted
grafting	more grafting
grandiose	more grandiose
grandstanding	more grandstanding
granted	more granted
granulated	more granulated
grappling	more grappling
grasping	more grasping
grassed	more grassed
grated	more grated
grateful	more grateful
gratifying	more gratifying
grating	more grating
grazed	more grazed
grazing	more grazing
greased	more greased
greeted	more greeted
greeting	more greeting
gregarious	more gregarious
grieved	more grieved
grieving	more grieving
grilled	more grilled
grilling	more grilling
grimacing	more grimacing
grinding	more grinding
grinning	more grinning
gripped	more gripped
gripping	more gripping
grizzled	more grizzled
groomed	more groomed
grooming	more grooming
grooved	more grooved
grooving	more grooving
groping	more groping
ground	more ground
groundbreaking	more groundbreaking
grounded	more grounded
groveling	more groveling
growing	more growing
growling	more growling
grubbing	more grubbing
grudging	more grudging
grueling	more grueling
gruesome	more gruesome
grumbling	more grumbling
grunting	more grunting
guaranteed	more guaranteed
guarded	more guarded
guarding	more guarding
guided	more guided
guiding	more guiding
guileless	more guileless
gullible	more gullible
gurgling	more gurgling
gushing	more gushing
gutted	more gutted
gutting	more gutting
guttural	more guttural
guzzling	more guzzling
gyrating	more gyrating
hacked	more hacked
hacking	more hacking
hackneyed	more hackneyed
haggling	more haggling
hailed	more hailed
hairless	more hairless
hallowed	more hallowed
hammered	more hammered
hammering	more hammering
handcrafted	more handcrafted
handicapped	more handicapped
handicapping	more handicapping
handled	more handled
handling	more handling
handpainted	more handpainted
handpicked	more handpicked
hanging	more hanging
harassed	more harassed
harassing	more harassing
hardboiled	more hardboiled
hardened	more hardened
hardening	more hardening
hardheaded	more hardheaded
hardworking	more hardworking
harebrained	more harebrained
harmful	more harmful
harmless	more harmless
harmonious	more harmonious
harmonized	more harmonized
harmonizing	more harmonizing
harnessed	more harnessed
harried	more harried
harrowing	more harrowing
harvested	more harvested
harvesting	more harvesting
hashed	more hashed
hashing	more hashing
hassling	more hassling
hatched	more hatched
hatching	more hatching
hated	more hated
hateful	more hateful
hating	more hating
hauling	more hauling
haunted	more haunted
haunting	more haunting
hawking	more hawking
hazardous	more hazardous
headed	more headed
headlining	more headlining
healed	more healed
healing	more healing
healthful	more healthful
heaped	more heaped
heartbreaking	more heartbreaking
heartless	more heartless
heartrending	more heartrending
heartwarming	more heartwarming
heated	more heated
heating	more heating
heavenly	more heavenly
heaving	more heaving
heckling	more heckling
hectic	more hectic
hectoring	more hectoring
hedged	more hedged
hedonistic	more hedonistic
heightened	more heightened
heinous	more heinous
helpful	more helpful
helping	more helping
helpless	more helpless
hemming	more hemming
herding	more herding
herniated	more herniated
heroic	more heroic
heterosexual	more heterosexual
hibernating	more hibernating
hidden	more hidden
hideous	more hideous
hiding	more hiding
hierarchical	more hierarchical
highlighted	more highlighted
highlighting	more highlighting
hightech	more hightech
hijacked	more hijacked
hijacking	more hijacking
hiking	more hiking
hindering	more hindering
hinged	more hinged
hired	more hired
hiring	more hiring
hirsute	more hirsute
hissing	more hissing
historical	more historical
hitchhiking	more hitchhiking
hitting	more hitting
hoarding	more hoarding
hobbled	more hobbled
hogtied	more hogtied
hoisted	more hoisted
hokey	more hokey
holding	more holding
hollowed	more hollowed
homeless	more homeless
homesteading	more homesteading
homey	more homey
homing	more homing
homogeneous	more homogeneous
homogenized	more homogenized
homogenizing	more homogenizing
homogenous	more homogenous
honed	more honed
honeyed	more honeyed
honking	more honking
honorable	more honorable
honored	more honored
honoured	more honoured
hooded	more hooded
hooked	more hooked
hooking	more hooking
hooting	more hooting
hopeful	more hopeful
hopeless	more hopeless
hoping	more hoping
hopping	more hopping
horizontal	more horizontal
horned	more horned
horrible	more horrible
horrid	more horrid
horrifying	more horrifying
hospitable	more hospitable
hospitalized	more hospitalized
hosted	more hosted
hostile	more hostile
hosting	more hosting
hotheaded	more hotheaded
housekeeping	more housekeeping
hovering	more hovering
howling	more howling
huffing	more huffing
hugging	more hugging
hulking	more hulking
humanized	more humanized
humanizing	more humanizing
humdrum	more humdrum
humid	more humid
humified	more humified
humiliated	more humiliated
humiliating	more humiliating
humming	more humming
humorless	more humorless
humorous	more humorous
humourless	more humourless
humped	more humped
humping	more humping
hunched	more hunched
hunted	more hunted
hunting	more hunting
hurled	more hurled
hurling	more hurling
hurried	more hurried
hurting	more hurting
hushed	more hushed
hustling	more hustling
hybridized	more hybridized
hydrating	more hydrating
hygienic	more hygienic
hyped	more hyped
hyperactive	more hyperactive
hyperlinked	more hyperlinked
hyperventilating	more hyperventilating
hyping	more hyping
hypnotic	more hypnotic
hypothesized	more hypothesized
iced	more iced
icing	more icing
ideal	more ideal
idealistic	more idealistic
idealized	more idealized
identifiable	more identifiable
identified	more identified
identifying	more identifying
idling	more idling
idolized	more idolized
ignited	more ignited
ignorant	more ignorant
illegal	more illegal
illiterate	more illiterate
illuminated	more illuminated
illuminating	more illuminating
illusive	more illusive
illusory	more illusory
illustrated	more illustrated
illustrating	more illustrating
illustrative	more illustrative
imaginative	more imaginative
imagined	more imagined
imaging	more imaging
imbalanced	more imbalanced
imbedded	more imbedded
imitative	more imitative
immaculate	more immaculate
immanent	more immanent
immaterial	more immaterial
immature	more immature
immediate	more immediate
immense	more immense
immersed	more immersed
immobile	more immobile
immodest	more immodest
immoral	more immoral
immortal	more immortal
immovable	more immovable
immunocompromised	more immunocompromised
immunosuppressed	more immunosuppressed
immutable	more immutable
impacted	more impacted
impacting	more impacting
impaired	more impaired
impairing	more impairing
impartial	more impartial
impassioned	more impassioned
impatient	more impatient
impeccable	more impeccable
impending	more impending
impenetrable	more impenetrable
imperative	more imperative
imperceptible	more imperceptible
imperfect	more imperfect
imperious	more imperious
impermanent	more impermanent
impermeable	more impermeable
impersonal	more impersonal
imperturbable	more imperturbable
impervious	more impervious
impish	more impish
implacable	more implacable
implanted	more implanted
implausible	more implausible
implemented	more implemented
implementing	more implementing
implied	more implied
impolite	more impolite
important	more important
imported	more imported
importing	more importing
imposed	more imposed
imposing	more imposing
impossible	more impossible
impotent	more impotent
impoverished	more impoverished
impractical	more impractical
impregnable	more impregnable
impressed	more impressed
impressing	more impressing
impressionable	more impressionable
impressive	more impressive
imprinted	more imprinted
imprinting	more imprinting
imprisoned	more imprisoned
imprisoning	more imprisoning
improbable	more improbable
improvident	more improvident
improvised	more improvised
improvising	more improvising
imprudent	more imprudent
impudent	more impudent
impure	more impure
inaccessible	more inaccessible
inaccurate	more inaccurate
inactive	more inactive
inadequate	more inadequate
inanimate	more inanimate
inarticulate	more inarticulate
inattentive	more inattentive
inauspicious	more inauspicious
inbred	more inbred
incapable	more incapable
incapacitated	more incapacitated
incapacitating	more incapacitating
incarcerated	more incarcerated
incendiary	more incendiary
incessant	more incessant
incidental	more incidental
incised	more incised
incisive	more incisive
incited	more incited
inclined	more inclined
inclusive	more inclusive
incoherent	more incoherent
incoming	more incoming
incompetent	more incompetent
incomplete	more incomplete
incomprehensible	more incomprehensible
inconclusive	more inconclusive
incongruous	more incongruous
inconsequential	more inconsequential
inconsiderable	more inconsiderable
inconsistent	more inconsistent
inconspicuous	more inconspicuous
incontinent	more incontinent
inconvenient	more inconvenient
incorporated	more incorporated
incorrect	more incorrect
incorrigible	more incorrigible
incredible	more incredible
incredulous	more incredulous
incriminating	more incriminating
indecipherable	more indecipherable
indecisive	more indecisive
indefinite	more indefinite
indented	more indented
indentured	more indentured
independent	more independent
indestructible	more indestructible
indeterminate	more indeterminate
indexed	more indexed
indexing	more indexing
indicated	more indicated
indicating	more indicating
indicted	more indicted
indigestible	more indigestible
indiscriminate	more indiscriminate
indispensable	more indispensable
indistinct	more indistinct
individual	more individual
indoctrinated	more indoctrinated
indomitable	more indomitable
induced	more induced
indulged	more indulged
industrialized	more industrialized
industrious	more industrious
inebriated	more inebriated
ineffective	more ineffective
ineffectual	more ineffectual
inelastic	more inelastic
inelegant	more inelegant
inert	more inert
inescapable	more inescapable
inevitable	more inevitable
inexpensive	more inexpensive
inexperienced	more inexperienced
inexplicable	more inexplicable
infallible	more infallible
infamous	more infamous
infatuated	more infatuated
infected	more infected
infectious	more infectious
inferior	more inferior
infertile	more infertile
infested	more infested
infiltrating	more infiltrating
infinite	more infinite
inflamed	more inflamed
inflated	more inflated
inflating	more inflating
inflexible	more inflexible
inflicted	more inflicted
influencing	more influencing
influential	more influential
informal	more informal
informative	more informative
informed	more informed
informing	more informing
infuriated	more infuriated
infused	more infused
ingenious	more ingenious
ingenuous	more ingenuous
ingrained	more ingrained
inhabited	more inhabited
inhabiting	more inhabiting
inhaled	more inhaled
inherited	more inherited
inhospitable	more inhospitable
inhuman	more inhuman
initiated	more initiated
initiating	more initiating
injected	more injected
injecting	more injecting
injured	more injured
inked	more inked
inking	more inking
inky	more inky
innate	more innate
innocent	more innocent
innocuous	more innocuous
innovating	more innovating
inoffensive	more inoffensive
inoperable	more inoperable
inorganic	more inorganic
inquiring	more inquiring
inquisitive	more inquisitive
insatiable	more insatiable
inscribed	more inscribed
inscrutable	more inscrutable
insecure	more insecure
insensate	more insensate
insensible	more insensible
insensitive	more insensitive
inseparable	more inseparable
inserted	more inserted
insidious	more insidious
insightful	more insightful
insignificant	more insignificant
insinuating	more insinuating
insistent	more insistent
inspected	more inspected
inspecting	more inspecting
inspired	more inspired
inspiring	more inspiring
installed	more installed
installing	more installing
instant	more instant
instantaneous	more instantaneous
instilled	more instilled
instinctive	more instinctive
institutionalized	more institutionalized
instructing	more instructing
instructive	more instructive
insubstantial	more insubstantial
insufficient	more insufficient
insular	more insular
insulated	more insulated
insulating	more insulating
insulting	more insulting
insured	more insured
insuring	more insuring
insurmountable	more insurmountable
intangible	more intangible
integrated	more integrated
integrating	more integrating
intellectual	more intellectual
intelligent	more intelligent
intended	more intended
intensified	more intensified
intensive	more intensive
intent	more intent
interacting	more interacting
interactive	more interactive
intercepted	more intercepted
interconnected	more interconnected
interconnecting	more interconnecting
interested	more interested
interesting	more interesting
interfering	more interfering
interlaced	more interlaced
interlinked	more interlinked
interlocked	more interlocked
interlocking	more interlocking
intermediate	more intermediate
intermingled	more intermingled
international	more international
interpolated	more interpolated
interpreted	more interpreted
interpreting	more interpreting
interrelated	more interrelated
interrupted	more interrupted
interrupting	more interrupting
interspersed	more interspersed
intertwined	more intertwined
intertwining	more intertwining
intervening	more intervening
interviewed	more interviewed
interviewing	more interviewing
intimate	more intimate
intimated	more intimated
intimidating	more intimidating
intoxicated	more intoxicated
intoxicating	more intoxicating
intractable	more intractable
intrepid	more intrepid
intricate	more intricate
intriguing	more intriguing
introducing	more introducing
introverted	more introverted
intruding	more intruding
intrusive	more intrusive
intuitive	more intuitive
inundated	more inundated
invading	more invading
invalidated	more invalidated
invasive	more invasive
invented	more invented
inventing	more inventing
inventive	more inventive
inverted	more inverted
invested	more invested
investigated	more investigated
investigating	more investigating
investing	more investing
invigorating	more invigorating
inviolable	more inviolable
invisible	more invisible
invited	more invited
inviting	more inviting
invoicing	more invoicing
invoked	more invoked
involuntary	more involuntary
involved	more involved
invulnerable	more invulnerable
ionized	more ionized
ionizing	more ionizing
irate	more irate
iridescent	more iridescent
irksome	more irksome
irradiated	more irradiated
irrational	more irrational
irregular	more irregular
irrelevant	more irrelevant
irreligious	more irreligious
irreplaceable	more irreplaceable
irrepressible	more irrepressible
irresistible	more irresistible
irresponsible	more irresponsible
irreverent	more irreverent
irreversible	more irreversible
irrevocable	more irrevocable
irrigated	more irrigated
irritable	more irritable
irritating	more irritating
isolated	more isolated
issued	more issued
issuing	more issuing
itching	more itching
itemized	more itemized
iterated	more iterated
jabbering	more jabbering
jabbing	more jabbing
jaded	more jaded
jagged	more jagged
jailed	more jailed
jammed	more jammed
jamming	more jamming
jangling	more jangling
jangly	more jangly
jarring	more jarring
jaundiced	more jaundiced
jealous	more jealous
jeopardized	more jeopardized
jerking	more jerking
jesting	more jesting
jetting	more jetting
jeweled	more jeweled
jigging	more jigging
jilted	more jilted
jingling	more jingling
jittery	more jittery
jocular	more jocular
jogging	more jogging
jointed	more jointed
joking	more joking
jolting	more jolting
jousting	more jousting
joyful	more joyful
joyous	more joyous
judged	more judged
judging	more judging
juggling	more juggling
juiced	more juiced
jumbled	more jumbled
jumping	more jumping
junior	more junior
junked	more junked
juried	more juried
justified	more justified
jutting	more jutting
kayaking	more kayaking
keening	more keening
keyed	more keyed
kicked	more kicked
kicking	more kicking
kidnapped	more kidnapped
kidnapping	more kidnapping
killed	more killed
killing	more killing
kindhearted	more kindhearted
kindled	more kindled
kingly	more kingly
kissing	more kissing
kneading	more kneading
kneeling	more kneeling
knitted	more knitted
knitting	more knitting
knobbly	more knobbly
knotted	more knotted
knowledgeable	more knowledgeable
kosher	more kosher
labeled	more labeled
labeling	more labeling
labelled	more labelled
laboring	more laboring
labyrinthine	more labyrinthine
laced	more laced
laconic	more laconic
lacquered	more lacquered
lactating	more lactating
lacy	more lacy
ladylike	more ladylike
laid	more laid
laidback	more laidback
lamenting	more lamenting
laminated	more laminated
landed	more landed
landing	more landing
landscaped	more landscaped
landscaping	more landscaping
languid	more languid
languishing	more languishing
lapping	more lapping
lashing	more lashing
lasting	more lasting
laughable	more laughable
laughing	more laughing
launched	more launched
launching	more launching
lawmaking	more lawmaking
layered	more layered
laying	more laying
lazing	more lazing
leached	more leached
leaded	more leaded
leaden	more leaden
leading	more leading
leaked	more leaked
leaking	more leaking
leaning	more leaning
leaping	more leaping
learned	more learned
learning	more learning
leased	more leased
leashed	more leashed
leasing	more leasing
leathery	more leathery
leavened	more leavened
lecherous	more lecherous
lecturing	more lecturing
leeching	more leeching
leering	more leering
legal	more legal
legalized	more legalized
legible	more legible
legislated	more legislated
legislating	more legislating
legitimate	more legitimate
leisurely	more leisurely
lending	more lending
lengthening	more lengthening
lent	more lent
lethal	more lethal
lethargic	more lethargic
leveled	more leveled
leveraged	more leveraged
lexicalized	more lexicalized
liable	more liable
liberal	more liberal
liberalizing	more liberalizing
liberated	more liberated
liberating	more liberating
licensed	more licensed
licensing	more licensing
licked	more licked
licking	more licking
lifeless	more lifeless
lifesaving	more lifesaving
lifted	more lifted
lifting	more lifting
lighted	more lighted
lightheaded	more lightheaded
lighthearted	more lighthearted
lighting	more lighting
lightweight	more lightweight
likable	more likable
lilting	more lilting
limber	more limber
limited	more limited
limiting	more limiting
limitless	more limitless
limpid	more limpid
limping	more limping
linear	more linear
lined	more lined
lingering	more lingering
linked	more linked
linking	more linking
lipophilic	more lipophilic
liquefied	more liquefied
liquid	more liquid
liquidating	more liquidating
listed	more listed
listening	more listening
listing	more listing
listless	more listless
literal	more literal
lithe	more lithe
littered	more littered
livable	more livable
livid	more livid
living	more living
loaded	more loaded
loading	more loading
loaned	more loaned
loathsome	more loathsome
lobbying	more lobbying
local	more local
localized	more localized
locked	more locked
locking	more locking
lodging	more lodging
lofted	more lofted
logged	more logged
logging	more logging
logical	more logical
longing	more longing
longstanding	more longstanding
longwinded	more longwinded
loomed	more loomed
looming	more looming
looped	more looped
loosening	more loosening
looted	more looted
looting	more looting
loping	more loping
lopsided	more lopsided
losing	more losing
lounging	more lounging
lovable	more lovable
loveable	more loveable
loved	more loved
lovemaking	more lovemaking
loving	more loving
lowering	more lowering
loyal	more loyal
lubricated	more lubricated
lubricating	more lubricating
lubricious	more lubricious
lucid	more lucid
lucrative	more lucrative
ludicrous	more ludicrous
lugging	more lugging
lumbering	more lumbering
luminescent	more luminescent
luminous	more luminous
lunging	more lunging
lurching	more lurching
luring	more luring
lurking	more lurking
luscious	more luscious
lustrous	more lustrous
luxurious	more luxurious
lying	more lying
lyrical	more lyrical
macabre	more macabre
machined	more machined
macho	more macho
maddened	more maddened
maddening	more maddening
magical	more magical
magisterial	more magisterial
magnetized	more magnetized
magnificent	more magnificent
magnified	more magnified
magnifying	more magnifying
mailed	more mailed
maintained	more maintained
maintaining	more maintaining
majestic	more majestic
major	more major
making	more making
malformed	more malformed
malfunctioning	more malfunctioning
malicious	more malicious
malignant	more malignant
malleable	more malleable
malnourished	more malnourished
malted	more malted
malting	more malting
managed	more managed
managing	more managing
mandated	more mandated
maneuverable	more maneuverable
mangled	more mangled
mangling	more mangling
manicured	more manicured
manifested	more manifested
manipulated	more manipulated
manipulating	more manipulating
manipulative	more manipulative
manned	more manned
manoeuvrable	more manoeuvrable
manufactured	more manufactured
manufacturing	more manufacturing
mapped	more mapped
mapping	more mapping
marauding	more marauding
marbled	more marbled
marbling	more marbling
marching	more marching
marginalized	more marginalized
marinated	more marinated
marked	more marked
marketed	more marketed
marketing	more marketing
marking	more marking
married	more married
marrying	more marrying
marshalling	more marshalling
martyred	more martyred
masculine	more masculine
mashed	more mashed
masked	more masked
massaging	more massaging
massed	more massed
massive	more massive
mastered	more mastered
masterful	more masterful
mastering	more mastering
matching	more matching
materialized	more materialized
mathematical	more mathematical
mating	more mating
matted	more matted
matured	more matured
maturing	more maturing
meager	more meager
meandering	more meandering
meaningful	more meaningful
meaningless	more meaningless
measured	more measured
measuring	more measuring
mechanical	more mechanical
mechanized	more mechanized
meddling	more meddling
meditating	more meditating
meditative	more meditative
meeting	more meeting
melodic	more melodic
melodious	more melodious
melodramatic	more melodramatic
melted	more melted
melting	more melting
memorable	more memorable
memorized	more memorized
menacing	more menacing
mentoring	more mentoring
meowing	more meowing
merchandising	more merchandising
merciful	more merciful
merciless	more merciless
mercurial	more mercurial
merited	more merited
meshed	more meshed
mesmerizing	more mesmerizing
metallic	more metallic
metered	more metered
methodical	more methodical
meticulous	more meticulous
microscopic	more microscopic
midwestern	more midwestern
migrating	more migrating
milked	more milked
milled	more milled
milling	more milling
mincing	more mincing
mindless	more mindless
mined	more mined
mineralized	more mineralized
mingling	more mingling
miniaturized	more miniaturized
mining	more mining
miniscule	more miniscule
ministering	more ministering
minor	more minor
minuscule	more minuscule
miraculous	more miraculous
mirrored	more mirrored
misbehaving	more misbehaving
mischievous	more mischievous
misdirected	more misdirected
miserable	more miserable
misfolded	more misfolded
misguided	more misguided
misleading	more misleading
mismatched	more mismatched
misplaced	more misplaced
misshapen	more misshapen
misting	more misting
mistreated	more mistreated
mixed	more mixed
mixing	more mixing
moaned	more moaned
moaning	more moaning
mobbed	more mobbed
mobile	more mobile
mobilized	more mobilized
mocking	more mocking
modeling	more modeling
moderated	more moderated
modernized	more modernized
modernizing	more modernizing
modest	more modest
modified	more modified
modulated	more modulated
modulating	more modulating
moistened	more moistened
moistening	more moistening
moisturized	more moisturized
moisturizing	more moisturizing
molded	more molded
molding	more molding
molested	more molested
molesting	more molesting
moneyed	more moneyed
moneymaking	more moneymaking
monitored	more monitored
monitoring	more monitoring
monochromatic	more monochromatic
monotonous	more monotonous
monstrous	more monstrous
mooching	more mooching
mooning	more mooning
moored	more moored
mooring	more mooring
moral	more moral
moralizing	more moralizing
morbid	more morbid
mordant	more mordant
moronic	more moronic
morphing	more morphing
mortal	more mortal
moshing	more moshing
motionless	more motionless
motivated	more motivated
motivating	more motivating
motley	more motley
motoring	more motoring
motorized	more motorized
mottled	more mottled
mottling	more mottling
moulded	more moulded
mouldering	more mouldering
mounded	more mounded
mounted	more mounted
mounting	more mounting
mournful	more mournful
mourning	more mourning
mousing	more mousing
mouthwatering	more mouthwatering
movable	more movable
moving	more moving
mowed	more mowed
mowing	more mowing
muckraking	more muckraking
muddied	more muddied
muddled	more muddled
muffled	more muffled
mugging	more mugging
mulled	more mulled
multicolored	more multicolored
multifaceted	more multifaceted
multiplying	more multiplying
multithreaded	more multithreaded
mumbled	more mumbled
mumbling	more mumbling
mummified	more mummified
munching	more munching
mundane	more mundane
murdered	more murdered
murdering	more murdering
murmuring	more murmuring
muscled	more muscled
muscular	more muscular
musical	more musical
mutable	more mutable
mutated	more mutated
mutating	more mutating
muted	more muted
mutilated	more mutilated
muttered	more muttered
muzzled	more muzzled
myopic	more myopic
mysterious	more mysterious
mystifying	more mystifying
mythological	more mythological
nagging	more nagging
nailbiting	more nailbiting
nailed	more nailed
naive	more naive
named	more named
naming	more naming
napping	more napping
narrated	more narrated
narrowminded	more narrowminded
national	more national
nationalized	more nationalized
natural	more natural
naturalized	more naturalized
nauseating	more nauseating
navigating	more navigating
nebulous	more nebulous
necessitated	more necessitated
needed	more needed
needling	more needling
negative	more negative
neglected	more neglected
negligible	more negligible
negotiated	more negotiated
negotiating	more negotiating
neighboring	more neighboring
neoclassical	more neoclassical
nerveless	more nerveless
nervewracking	more nervewracking
nervous	more nervous
nested	more nested
nesting	more nesting
nestled	more nestled
netted	more netted
netting	more netting
networked	more networked
networking	more networking
neurotic	more neurotic
neutered	more neutered
neutral	more neutral
nibbling	more nibbling
niggling	more niggling
nocturnal	more nocturnal
nodding	more nodding
noiseless	more noiseless
nominated	more nominated
nonchalant	more nonchalant
nonconforming	more nonconforming
nondescript	more nondescript
nonviolent	more nonviolent
normal	more normal
normalized	more normalized
normalizing	more normalizing
nosey	more nosey
nostalgic	more nostalgic
notable	more notable
notched	more notched
noticeable	more noticeable
nourishing	more nourishing
noxious	more noxious
nuanced	more nuanced
nucleated	more nucleated
nugatory	more nugatory
numbered	more numbered
numbing	more numbing
numerate	more numerate
nursing	more nursing
nurtured	more nurtured
nurturing	more nurturing
nutritious	more nutritious
nuts	more nuts
obedient	more obedient
obese	more obese
obeyed	more obeyed
obeying	more obeying
objective	more objective
obligated	more obligated
obligatory	more obligatory
obliging	more obliging
oblique	more oblique
oblivious	more oblivious
oblong	more oblong
obnoxious	more obnoxious
obscene	more obscene
obscuring	more obscuring
obsequious	more obsequious
observant	more observant
observing	more observing
obsessed	more obsessed
obsolete	more obsolete
obstinate	more obstinate
obtuse	more obtuse
obvious	more obvious
occupied	more occupied
occupying	more occupying
oceangoing	more oceangoing
odious	more odious
offended	more offended
offending	more offending
offensive	more offensive
offered	more offered
official	more official
officiating	more officiating
ogling	more ogling
oiled	more oiled
oiling	more oiling
ominous	more ominous
omnivorous	more omnivorous
oncoming	more oncoming
onesided	more onesided
onstage	more onstage
oozing	more oozing
opaque	more opaque
opened	more opened
opening	more opening
operated	more operated
operating	more operating
opinionated	more opinionated
opposable	more opposable
opposed	more opposed
opposing	more opposing
oppressed	more oppressed
oppressing	more oppressing
oppressive	more oppressive
optimistic	more optimistic
optimized	more optimized
optional	more optional
orbiting	more orbiting
orchestrated	more orchestrated
ordained	more ordained
ordered	more ordered
ordering	more ordering
orderly	more orderly
organic	more organic
organised	more organised
organized	more organized
organizing	more organizing
oriented	more oriented
orienteering	more orienteering
orienting	more orienting
original	more original
ornamented	more ornamented
ornate	more ornate
orotund	more orotund
orphaned	more orphaned
oscillating	more oscillating
ostentatious	more ostentatious
outcast	more outcast
outdated	more outdated
outgoing	more outgoing
outlawed	more outlawed
outlined	more outlined
outlining	more outlining
outlying	more outlying
outmoded	more outmoded
outnumbered	more outnumbered
outraged	more outraged
outsourced	more outsourced
outsourcing	more outsourcing
outspoken	more outspoken
overarching	more overarching
overbearing	more overbearing
overburdened	more overburdened
overcharged	more overcharged
overcooked	more overcooked
overcrowded	more overcrowded
overdrawn	more overdrawn
overdue	more overdue
overexposed	more overexposed
overextended	more overextended
overflowing	more overflowing
overhanging	more overhanging
overheated	more overheated
overheating	more overheating
overloaded	more overloaded
overlooked	more overlooked
overlooking	more overlooking
overlying	more overlying
overplayed	more overplayed
overpopulated	more overpopulated
overpowering	more overpowering
overpriced	more overpriced
overreaching	more overreaching
overseas	more overseas
overseeing	more overseeing
oversimplified	more oversimplified
oversized	more oversized
overstretched	more overstretched
overstuffed	more overstuffed
overt	more overt
overtaking	more overtaking
overtired	more overtired
overturned	more overturned
overused	more overused
overweening	more overweening
overwhelmed	more overwhelmed
overwhelming	more overwhelming
overworked	more overworked
owed	more owed
owing	more owing
owned	more owned
owning	more owning
oxidizing	more oxidizing
paced	more paced
pacing	more pacing
packaged	more packaged
packaging	more packaging
packed	more packed
packing	more packing
padded	more padded
padding	more padding
paddling	more paddling
paged	more paged
paging	more paging
paid	more paid
pained	more pained
painful	more painful
painless	more painless
painstaking	more painstaking
painted	more painted
painting	more painting
pallid	more pallid
palpable	more palpable
palpitating	more palpitating
pampered	more pampered
pampering	more pampering
pandering	more pandering
panhandling	more panhandling
panicked	more panicked
panning	more panning
panting	more panting
paralyzed	more paralyzed
paralyzing	more paralyzing
parameterized	more parameterized
paranoid	more paranoid
parasitic	more parasitic
parasitized	more parasitized
parched	more parched
parching	more parching
parenting	more parenting
parked	more parked
parking	more parking
parsed	more parsed
parsing	more parsing
participating	more participating
partisan	more partisan
partitioned	more partitioned
partitioning	more partitioning
partnering	more partnering
partying	more partying
passed	more passed
passing	more passing
passionate	more passionate
passionless	more passionless
passive	more passive
pasteurized	more pasteurized
patched	more patched
patented	more patented
patenting	more patenting
pathetic	more pathetic
patient	more patient
patriotic	more patriotic
patrolled	more patrolled
patrolling	more patrolling
patterned	more patterned
paved	more paved
pawing	more pawing
paying	more paying
peaceful	more peaceful
peaked	more peaked
pecking	more pecking
peculiar	more peculiar
peddling	more peddling
pedestrian	more pedestrian
pedigreed	more pedigreed
peeing	more peeing
peeled	more peeled
peeling	more peeling
peeping	more peeping
peering	more peering
peevish	more peevish
penalizing	more penalizing
penetrating	more penetrating
penned	more penned
peppered	more peppered
perceived	more perceived
perceptible	more perceptible
perceptive	more perceptive
perched	more perched
perching	more perching
percussive	more percussive
perennial	more perennial
perfected	more perfected
perforated	more perforated
performed	more performed
performing	more performing
perfumed	more perfumed
perilous	more perilous
periodic	more periodic
peripheral	more peripheral
perishable	more perishable
permanent	more permanent
permeable	more permeable
permitting	more permitting
pernicious	more pernicious
perpendicular	more perpendicular
perplexed	more perplexed
perplexing	more perplexing
persecuted	more persecuted
persecuting	more persecuting
persevering	more persevering
persistent	more persistent
personal	more personal
personalized	more personalized
personalizing	more personalizing
personified	more personified
persuading	more persuading
persuasive	more persuasive
pert	more pert
pertinacious	more pertinacious
pervading	more pervading
pervasive	more pervasive
perverted	more perverted
pestering	more pestering
petite	more petite
petitioning	more petitioning
petrified	more petrified
petted	more petted
philandering	more philandering
philosophical	more philosophical
philosophizing	more philosophizing
photocopied	more photocopied
photogenic	more photogenic
photographed	more photographed
photographing	more photographing
physical	more physical
picked	more picked
picketing	more picketing
picking	more picking
pickled	more pickled
pieced	more pieced
pierced	more pierced
piercing	more piercing
pigheaded	more pigheaded
pigmented	more pigmented
pilfering	more pilfering
pillaging	more pillaging
piloting	more piloting
pimped	more pimped
pimping	more pimping
pining	more pining
pinned	more pinned
pinpointed	more pinpointed
pioneering	more pioneering
pious	more pious
piped	more piped
piquant	more piquant
pirating	more pirating
pissed	more pissed
pitched	more pitched
pitching	more pitching
pitied	more pitied
pitiless	more pitiless
pitted	more pitted
pitting	more pitting
pitying	more pitying
pivoting	more pivoting
placid	more placid
plaintive	more plaintive
planed	more planed
planing	more planing
planned	more planned
planning	more planning
planted	more planted
planting	more planting
plastered	more plastered
plastering	more plastering
plastic	more plastic
plated	more plated
platonic	more platonic
playable	more playable
played	more played
playful	more playful
playing	more playing
playmaking	more playmaking
pleading	more pleading
pleased	more pleased
pleasing	more pleasing
pleasurable	more pleasurable
pleated	more pleated
plebeian	more plebeian
plentiful	more plentiful
pliable	more pliable
pliant	more pliant
plodding	more plodding
plotted	more plotted
plotting	more plotting
ploughing	more ploughing
plowed	more plowed
plowing	more plowing
plucked	more plucked
plucking	more plucking
plugged	more plugged
plumbing	more plumbing
plumped	more plumped
plundering	more plundering
plunging	more plunging
poached	more poached
poaching	more poaching
pockmarked	more pockmarked
poetic	more poetic
poetical	more poetical
poignant	more poignant
pointed	more pointed
pointing	more pointing
pointless	more pointless
poised	more poised
poisoned	more poisoned
poisoning	more poisoning
poisonous	more poisonous
pokey	more pokey
poking	more poking
polarized	more polarized
polarizing	more polarizing
policing	more policing
policymaking	more policymaking
polished	more polished
polishing	more polishing
political	more political
politicized	more politicized
polling	more polling
polluted	more polluted
polluting	more polluting
ponderous	more ponderous
pontificating	more pontificating
popped	more popped
popping	more popping
popular	more popular
popularized	more popularized
popularizing	more popularizing
populated	more populated
populous	more populous
pornographic	more pornographic
porous	more porous
portable	more portable
portentous	more portentous
posed	more posed
posing	more posing
positioning	more positioning
positive	more positive
possessed	more possessed
posted	more posted
posting	more posting
postulated	more postulated
posturing	more posturing
potent	more potent
potholed	more potholed
potted	more potted
pounded	more pounded
pounding	more pounding
poured	more poured
pouring	more pouring
pouting	more pouting
powdered	more powdered
powered	more powered
powering	more powering
powerless	more powerless
practical	more practical
practiced	more practiced
practicing	more practicing
pragmatic	more pragmatic
prancing	more prancing
praying	more praying
preached	more preached
preaching	more preaching
precious	more precious
precise	more precise
preconceived	more preconceived
predatory	more predatory
predefined	more predefined
predestined	more predestined
predetermined	more predetermined
predictable	more predictable
predicted	more predicted
predicting	more predicting
predisposing	more predisposing
preening	more preening
prefabricated	more prefabricated
preferred	more preferred
pregnant	more pregnant
preheated	more preheated
prejudiced	more prejudiced
premeditated	more premeditated
preordained	more preordained
prepared	more prepared
preparing	more preparing
prescient	more prescient
prescribed	more prescribed
prescribing	more prescribing
prescriptive	more prescriptive
presentable	more presentable
presented	more presented
presenting	more presenting
preserved	more preserved
preserving	more preserving
presidential	more presidential
presiding	more presiding
pressed	more pressed
pressing	more pressing
pressurised	more pressurised
pressurized	more pressurized
prestigious	more prestigious
pretending	more pretending
pretentious	more pretentious
priceless	more priceless
pricey	more pricey
pricked	more pricked
pricking	more pricking
primary	more primary
primed	more primed
priming	more priming
primitive	more primitive
principled	more principled
printed	more printed
printing	more printing
prioritizing	more prioritizing
prismatic	more prismatic
pristine	more pristine
privileged	more privileged
prized	more prized
probing	more probing
processed	more processed
processing	more processing
proclaimed	more proclaimed
procured	more procured
prodigal	more prodigal
prodigious	more prodigious
produced	more produced
producing	more producing
productive	more productive
profane	more profane
professed	more professed
professional	more professional
profitable	more profitable
profiteering	more profiteering
profiting	more profiting
programmed	more programmed
programming	more programming
progressing	more progressing
progressive	more progressive
prohibited	more prohibited
projected	more projected
projecting	more projecting
prolife	more prolife
proliferating	more proliferating
prolific	more prolific
prolonged	more prolonged
promiscuous	more promiscuous
promising	more promising
promoted	more promoted
promoting	more promoting
pronounced	more pronounced
propagated	more propagated
propagating	more propagating
propelled	more propelled
propelling	more propelling
proper	more proper
proposed	more proposed
proposing	more proposing
proprietary	more proprietary
proscribed	more proscribed
prosecuted	more prosecuted
proselytizing	more proselytizing
prospecting	more prospecting
protected	more protected
protecting	more protecting
protective	more protective
protesting	more protesting
prototyping	more prototyping
protracted	more protracted
protruding	more protruding
proved	more proved
proven	more proven
providing	more providing
provocative	more provocative
provoked	more provoked
provoking	more provoking
prowling	more prowling
prudent	more prudent
pruned	more pruned
pruning	more pruning
public	more public
publicizing	more publicizing
published	more published
publishing	more publishing
puckered	more puckered
puffed	more puffed
puffing	more puffing
pugilistic	more pugilistic
pugnacious	more pugnacious
pulled	more pulled
pulling	more pulling
pulsating	more pulsating
pulsed	more pulsed
pulsing	more pulsing
pulverized	more pulverized
pulverizing	more pulverizing
pummeling	more pummeling
pumped	more pumped
pumping	more pumping
punched	more punched
punching	more punching
punctual	more punctual
punctuated	more punctuated
punctured	more punctured
pungent	more pungent
punished	more punished
punishing	more punishing
punning	more punning
punting	more punting
purchased	more purchased
purchasing	more purchasing
purebred	more purebred
pureed	more pureed
purged	more purged
purging	more purging
purified	more purified
purifying	more purifying
purposeful	more purposeful
purposeless	more purposeless
purring	more purring
pursued	more pursued
pursuing	more pursuing
pushed	more pushed
pushing	more pushing
putting	more putting
puzzled	more puzzled
puzzling	more puzzling
qualified	more qualified
qualifying	more qualifying
quantitative	more quantitative
quarreling	more quarreling
quarrelsome	more quarrelsome
quarrying	more quarrying
quenched	more quenched
quenching	more quenching
questing	more questing
questionable	more questionable
questioning	more questioning
queuing	more queuing
quickened	more quickened
quickening	more quickening
quilted	more quilted
quivering	more quivering
quoted	more quoted
racing	more racing
racketeering	more racketeering
radiant	more radiant
radiated	more radiated
radiating	more radiating
radical	more radical
ragged	more ragged
raging	more raging
raiding	more raiding
raining	more raining
raised	more raised
raking	more raking
rallying	more rallying
rambling	more rambling
rambunctious	more rambunctious
ramming	more ramming
rampaging	more rampaging
ranching	more ranching
randomized	more randomized
ranked	more ranked
ranking	more ranking
rankling	more rankling
ranting	more ranting
rapacious	more rapacious
raped	more raped
raping	more raping
rapping	more rapping
rarified	more rarified
rasping	more rasping
ratcheting	more ratcheting
rated	more rated
ratified	more ratified
rating	more rating
rational	more rational
rationalizing	more rationalizing
rattled	more rattled
rattling	more rattling
raucous	more raucous
ravaged	more ravaged
ravaging	more ravaging
ravenous	more ravenous
raving	more raving
ravishing	more ravishing
reached	more reached
reacting	more reacting
read	more read
readable	more readable
reading	more reading
realistic	more realistic
realized	more realized
rearing	more rearing
rearranged	more rearranged
reasoned	more reasoned
reasoning	more reasoning
reassuring	more reassuring
rebelling	more rebelling
rebellious	more rebellious
rebounding	more rebounding
rebuilding	more rebuilding
recalled	more recalled
receding	more receding
received	more received
receiving	more receiving
receptive	more receptive
recessed	more recessed
recharged	more recharged
recharging	more recharging
recirculating	more recirculating
recited	more recited
reciting	more reciting
reckless	more reckless
reckoning	more reckoning
reclaimed	more reclaimed
reclining	more reclining
reclusive	more reclusive
recognisable	more recognisable
recognised	more recognised
recognizable	more recognizable
recognized	more recognized
recommended	more recommended
recommending	more recommending
reconditioned	more reconditioned
reconstructed	more reconstructed
recorded	more recorded
recording	more recording
recovered	more recovered
recovering	more recovering
recruited	more recruited
recruiting	more recruiting
rectangular	more rectangular
recurring	more recurring
recycled	more recycled
recycling	more recycling
reddened	more reddened
reddish	more reddish
redeemed	more redeemed
redirecting	more redirecting
reeking	more reeking
reeling	more reeling
refereed	more refereed
refereeing	more refereeing
referenced	more referenced
refinancing	more refinancing
refined	more refined
reflected	more reflected
reflecting	more reflecting
reflective	more reflective
reflexive	more reflexive
reformed	more reformed
reforming	more reforming
refracted	more refracted
refracting	more refracting
refreshed	more refreshed
refreshing	more refreshing
refried	more refried
refrigerated	more refrigerated
refrigerating	more refrigerating
refueling	more refueling
refurbished	more refurbished
refurbishing	more refurbishing
refused	more refused
refuted	more refuted
refuting	more refuting
regal	more regal
regenerating	more regenerating
regimented	more regimented
registered	more registered
registering	more registering
regressive	more regressive
regular	more regular
regulated	more regulated
regulating	more regulating
regurgitated	more regurgitated
rehabilitated	more rehabilitated
rehearsed	more rehearsed
rehearsing	more rehearsing
reigning	more reigning
reined	more reined
reinforced	more reinforced
reinforcing	more reinforcing
rejected	more rejected
rejoicing	more rejoicing
rejuvenating	more rejuvenating
relapsed	more relapsed
relapsing	more relapsing
relaxed	more relaxed
relaxing	more relaxing
released	more released
releasing	more releasing
relentless	more relentless
reliable	more reliable
reliant	more reliant
relieved	more relieved
relieving	more relieving
religious	more religious
relinquished	more relinquished
relocated	more relocated
remastered	more remastered
remembered	more remembered
reminding	more reminding
remixed	more remixed
remodeling	more remodeling
remorseless	more remorseless
removable	more removable
removing	more removing
rendered	more rendered
rending	more rending
renewed	more renewed
renovated	more renovated
renovating	more renovating
renowned	more renowned
rented	more rented
renting	more renting
reordering	more reordering
reorganizing	more reorganizing
repaired	more repaired
repairing	more repairing
repaying	more repaying
repeated	more repeated
repeating	more repeating
repenting	more repenting
repetitive	more repetitive
replaceable	more replaceable
replacing	more replacing
replicating	more replicating
reported	more reported
reporting	more reporting
representative	more representative
representing	more representing
repressed	more repressed
reprinted	more reprinted
reproduced	more reproduced
reproducing	more reproducing
reptilian	more reptilian
repulsive	more repulsive
reputable	more reputable
reputed	more reputed
requested	more requested
requesting	more requesting
required	more required
rescheduling	more rescheduling
rescued	more rescued
rescuing	more rescuing
researched	more researched
researching	more researching
reserved	more reserved
residential	more residential
resilient	more resilient
resisted	more resisted
resisting	more resisting
resolute	more resolute
resolved	more resolved
resonant	more resonant
resonating	more resonating
resounding	more resounding
respectable	more respectable
respected	more respected
respectful	more respectful
responding	more responding
responsible	more responsible
responsive	more responsive
rested	more rested
restful	more restful
resting	more resting
restless	more restless
restocking	more restocking
restored	more restored
restrained	more restrained
restraining	more restraining
restricted	more restricted
restricting	more restricting
restrictive	more restrictive
restructured	more restructured
resurrected	more resurrected
resuscitated	more resuscitated
retailing	more retailing
retained	more retained
retaining	more retaining
retarded	more retarded
retentive	more retentive
reticent	more reticent
reticulated	more reticulated
retired	more retired
retreating	more retreating
retrieved	more retrieved
retrieving	more retrieving
retrograde	more retrograde
returning	more returning
reunited	more reunited
revealed	more revealed
revealing	more revealing
revelatory	more revelatory
reveling	more reveling
reverberating	more reverberating
revered	more revered
reverenced	more reverenced
reverent	more reverent
reversed	more reversed
reversing	more reversing
reviewed	more reviewed
reviewing	more reviewing
reviled	more reviled
revised	more revised
revitalized	more revitalized
revitalizing	more revitalizing
revived	more revived
reviving	more reviving
revolting	more revolting
revolving	more revolving
revved	more revved
revving	more revving
rewarded	more rewarded
rewarding	more rewarding
rewinding	more rewinding
rewiring	more rewiring
rhyming	more rhyming
rhythmic	more rhythmic
ribbed	more ribbed
ridden	more ridden
riddled	more riddled
ridged	more ridged
ridiculous	more ridiculous
riding	more riding
riffing	more riffing
rigged	more rigged
rigging	more rigging
righteous	more righteous
rigid	more rigid
rigorous	more rigorous
ringed	more ringed
ringing	more ringing
rinsing	more rinsing
rioting	more rioting
ripened	more ripened
ripening	more ripening
ripped	more ripped
ripping	more ripping
rippled	more rippled
rippling	more rippling
risen	more risen
rising	more rising
ritualistic	more ritualistic
ritualized	more ritualized
riveted	more riveted
riveting	more riveting
roaming	more roaming
roaring	more roaring
roasted	more roasted
roasting	more roasting
robbing	more robbing
robed	more robed
rocked	more rocked
rocking	more rocking
roiling	more roiling
rolled	more rolled
rollicking	more rollicking
rolling	more rolling
romantic	more romantic
romanticized	more romanticized
romping	more romping
roosting	more roosting
rooted	more rooted
rooting	more rooting
roped	more roped
rotating	more rotating
rotting	more rotting
rounded	more rounded
roused	more roused
rousing	more rousing
routed	more routed
routine	more routine
routing	more routing
roving	more roving
rowing	more rowing
royal	more royal
rubbed	more rubbed
rubberized	more rubberized
rubbery	more rubbery
rubbing	more rubbing
rudimentary	more rudimentary
ruffled	more ruffled
ruggedized	more ruggedized
ruined	more ruined
ruinous	more ruinous
ruled	more ruled
ruling	more ruling
rumbling	more rumbling
ruminating	more ruminating
rumpled	more rumpled
running	more running
ruptured	more ruptured
rural	more rural
rushing	more rushing
rusted	more rusted
rustic	more rustic
rusting	more rusting
rustling	more rustling
ruthless	more ruthless
rutted	more rutted
rutting	more rutting
sacrificed	more sacrificed
sacrificing	more sacrificing
saddening	more saddening
saddled	more saddled
safeguarded	more safeguarded
safeguarding	more safeguarding
sagacious	more sagacious
sagging	more sagging
sailing	more sailing
salaried	more salaried
salient	more salient
salivating	more salivating
salted	more salted
saluted	more saluted
saluting	more saluting
salvaged	more salvaged
sampling	more sampling
sanctified	more sanctified
sanctioned	more sanctioned
sanctioning	more sanctioning
sanding	more sanding
sanitary	more sanitary
sanitized	more sanitized
sapping	more sapping
satisfied	more satisfied
satisfying	more satisfying
saturated	more saturated
savage	more savage
saved	more saved
saving	more saving
savoring	more savoring
savory	more savory
sawing	more sawing
scaffolding	more scaffolding
scalable	more scalable
scalded	more scalded
scalding	more scalding
scaled	more scaled
scaling	more scaling
scalloped	more scalloped
scamming	more scamming
scandalous	more scandalous
scanned	more scanned
scanning	more scanning
scarlet	more scarlet
scarred	more scarred
scarring	more scarring
scathing	more scathing
scattered	more scattered
scattering	more scattering
scavenging	more scavenging
scented	more scented
scheduled	more scheduled
scheduling	more scheduling
schematic	more schematic
scheming	more scheming
scholarly	more scholarly
schooling	more schooling
scientific	more scientific
scintillating	more scintillating
scoffing	more scoffing
scolding	more scolding
scooped	more scooped
scooping	more scooping
scorched	more scorched
scorching	more scorching
scored	more scored
scoring	more scoring
scorned	more scorned
scouring	more scouring
scouting	more scouting
scrambled	more scrambled
scrambling	more scrambling
scraped	more scraped
scraping	more scraping
scratched	more scratched
scratching	more scratching
screamed	more screamed
screaming	more screaming
screeching	more screeching
screechy	more screechy
screened	more screened
screening	more screening
screwed	more screwed
scribbled	more scribbled
scripted	more scripted
scripting	more scripting
scrolling	more scrolling
scrubbed	more scrubbed
scrubbing	more scrubbing
scrunched	more scrunched
sculpted	more sculpted
sculpting	more sculpting
sculptured	more sculptured
sculpturing	more sculpturing
scurrying	more scurrying
seafaring	more seafaring
seagoing	more seagoing
sealed	more sealed
sealing	more sealing
seamless	more seamless
searching	more searching
seared	more seared
searing	more searing
seasoned	more seasoned
seasoning	more seasoning
seaworthy	more seaworthy
secluded	more secluded
secondary	more secondary
secret	more secret
secreted	more secreted
secretive	more secretive
secular	more secular
secured	more secured
securing	more securing
sedate	more sedate
sedentary	more sedentary
seducing	more seducing
seductive	more seductive
seeded	more seeded
seeking	more seeking
seeping	more seeping
seething	more seething
segmented	more segmented
segregated	more segregated
segregating	more segregating
seized	more seized
selected	more selected
selecting	more selecting
selective	more selective
selfcontained	more selfcontained
selfish	more selfish
selfless	more selfless
selling	more selling
senior	more senior
sensational	more sensational
sensationalized	more sensationalized
sensible	more sensible
sensing	more sensing
sensitive	more sensitive
sensitized	more sensitized
sensual	more sensual
sensuous	more sensuous
sentenced	more sentenced
sentencing	more sentencing
sentimental	more sentimental
separated	more separated
separating	more separating
sequenced	more sequenced
sequestered	more sequestered
sequined	more sequined
serenading	more serenading
serialized	more serialized
serious	more serious
serrated	more serrated
served	more served
serviceable	more serviceable
serving	more serving
setting	more setting
settled	more settled
settling	more settling
severed	more severed
sewing	more sewing
sexless	more sexless
sexual	more sexual
shackled	more shackled
shaded	more shaded
shading	more shading
shadowed	more shadowed
shadowing	more shadowing
shaken	more shaken
shaking	more shaking
shambling	more shambling
shamed	more shamed
shaming	more shaming
shapeless	more shapeless
shaping	more shaping
shared	more shared
shareholding	more shareholding
sharing	more sharing
sharpened	more sharpened
shattered	more shattered
shattering	more shattering
shaved	more shaved
shaving	more shaving
sheared	more sheared
shed	more shed
shedding	more shedding
shelled	more shelled
sheltered	more sheltered
sheltering	more sheltering
shelving	more shelving
shielding	more shielding
shifted	more shifted
shifting	more shifting
shimmering	more shimmering
shimmery	more shimmery
shinning	more shinning
shipping	more shipping
shivering	more shivering
shocked	more shocked
shocking	more shocking
shooting	more shooting
shopping	more shopping
shorn	more shorn
shortlived	more shortlived
shouted	more shouted
shouting	more shouting
shoveling	more shoveling
showcased	more showcased
showcasing	more showcasing
shredded	more shredded
shredding	more shredding
shrieked	more shrieked
shrieking	more shrieking
shrinking	more shrinking
shriveled	more shriveled
shrivelled	more shrivelled
shrouded	more shrouded
shrunken	more shrunken
shuddering	more shuddering
shuffled	more shuffled
shuffling	more shuffling
shunned	more shunned
shunting	more shunting
shuttered	more shuttered
shutting	more shutting
sickening	more sickening
sidesplitting	more sidesplitting
sieving	more sieving
sifting	more sifting
sighing	more sighing
sightseeing	more sightseeing
signaling	more signaling
signalling	more signalling
signed	more signed
significant	more significant
signing	more signing
silenced	more silenced
silver	more silver
silvered	more silvered
simmering	more simmering
simpering	more simpering
simplified	more simplified
simulated	more simulated
simulating	more simulating
sinewy	more sinewy
singed	more singed
singing	more singing
singleminded	more singleminded
singular	more singular
sinister	more sinister
sinking	more sinking
sinning	more sinning
sinuous	more sinuous
sitting	more sitting
sizzling	more sizzling
skateboarding	more skateboarding
skating	more skating
skeptical	more skeptical
sketched	more sketched
sketching	more sketching
skewed	more skewed
skewered	more skewered
skewing	more skewing
skidding	more skidding
skiing	more skiing
skilled	more skilled
skillful	more skillful
skimmed	more skimmed
skimming	more skimming
skinned	more skinned
skinning	more skinning
skint	more skint
skipped	more skipped
skipping	more skipping
skittish	more skittish
skulking	more skulking
slacking	more slacking
slammed	more slammed
slamming	more slamming
slandering	more slandering
slanted	more slanted
slashed	more slashed
slashing	more slashing
slated	more slated
slaughtered	more slaughtered
slaughtering	more slaughtering
sleeping	more sleeping
sliced	more sliced
slicing	more slicing
sliding	more sliding
slimming	more slimming
slinging	more slinging
slipped	more slipped
slithering	more slithering
slithery	more slithery
slobbering	more slobbering
sloped	more sloped
sloping	more sloping
sloshing	more sloshing
slouched	more slouched
slugging	more slugging
sluggish	more sluggish
slumping	more slumping
slurring	more slurring
smashed	more smashed
smashing	more smashing
smeared	more smeared
smearing	more smearing
smelling	more smelling
smiling	more smiling
smirking	more smirking
smoked	more smoked
smoking	more smoking
smoldering	more smoldering
smoothed	more smoothed
smoothing	more smoothing
smothered	more smothered
smothering	more smothering
smouldering	more smouldering
smudged	more smudged
smuggled	more smuggled
smuggling	more smuggling
snacking	more snacking
snagged	more snagged
snaking	more snaking
snapped	more snapped
snapping	more snapping
snappish	more snappish
snarling	more snarling
snatched	more snatched
snatching	more snatching
sneaking	more sneaking
sneering	more sneering
sniffing	more sniffing
sniffling	more sniffling
sniping	more sniping
sniveling	more sniveling
snooping	more snooping
snoozing	more snoozing
snoring	more snoring
snorkling	more snorkling
snorting	more snorting
snuggling	more snuggling
soaked	more soaked
soaking	more soaking
soaring	more soaring
sobbing	more sobbing
sobering	more sobering
sociable	more sociable
social	more social
socializing	more socializing
sodden	more sodden
softened	more softened
soiled	more soiled
soldered	more soldered
soldering	more soldering
solemn	more solemn
solicited	more solicited
soliciting	more soliciting
solicitous	more solicitous
solidified	more solidified
solitary	more solitary
soloing	more soloing
solved	more solved
solving	more solving
somber	more somber
sombre	more sombre
songful	more songful
songwriting	more songwriting
sonorous	more sonorous
soothing	more soothing
sophisticated	more sophisticated
soporific	more soporific
sorrowful	more sorrowful
sorrowing	more sorrowing
sorted	more sorted
sorting	more sorting
soulful	more soulful
soulless	more soulless
soused	more soused
sowing	more sowing
spacious	more spacious
spamming	more spamming
spanked	more spanked
sparing	more sparing
sparked	more sparked
sparking	more sparking
sparkling	more sparkling
sparring	more sparring
spartan	more spartan
spawning	more spawning
speaking	more speaking
specialized	more specialized
specializing	more specializing
specific	more specific
specified	more specified
specifying	more specifying
speckled	more speckled
spectacular	more spectacular
speculating	more speculating
speeding	more speeding
spellbinding	more spellbinding
spelled	more spelled
spelling	more spelling
spending	more spending
spent	more spent
spewing	more spewing
spherical	more spherical
spiced	more spiced
spiked	more spiked
spiking	more spiking
spineless	more spineless
spinning	more spinning
spiraling	more spiraling
spired	more spired
spirited	more spirited
spiritual	more spiritual
spitting	more spitting
splashed	more splashed
splashing	more splashing
splattering	more splattering
spliced	more spliced
splintered	more splintered
splintering	more splintering
splitting	more splitting
spoiled	more spoiled
spoiling	more spoiling
sponging	more sponging
sponsored	more sponsored
sponsoring	more sponsoring
spontaneous	more spontaneous
spoofing	more spoofing
spooked	more spooked
spooled	more spooled
sporadic	more sporadic
spotless	more spotless
spotted	more spotted
spouting	more spouting
sprained	more sprained
sprawling	more sprawling
sprayed	more sprayed
spraying	more spraying
spreading	more spreading
springing	more springing
sprinkled	more sprinkled
sprinkling	more sprinkling
sprinting	more sprinting
sprouting	more sprouting
spruce	more spruce
sprung	more sprung
spun	more spun
spurned	more spurned
spurred	more spurred
spurting	more spurting
sputtering	more sputtering
spying	more spying
squabbling	more squabbling
squashed	more squashed
squatting	more squatting
squawking	more squawking
squeaking	more squeaking
squealing	more squealing
squeezable	more squeezable
squeezed	more squeezed
squeezing	more squeezing
squirming	more squirming
squirting	more squirting
squished	more squished
stabbing	more stabbing
stabile	more stabile
stabilizing	more stabilizing
stacked	more stacked
stacking	more stacking
staged	more staged
staggering	more staggering
staging	more staging
stagnant	more stagnant
staid	more staid
stained	more stained
staining	more staining
stalked	more stalked
stalking	more stalking
stalled	more stalled
stammering	more stammering
stamped	more stamped
stamping	more stamping
standardized	more standardized
standing	more standing
starched	more starched
stargazing	more stargazing
staring	more staring
starred	more starred
starring	more starring
starting	more starting
startled	more startled
startling	more startling
starved	more starved
starving	more starving
stated	more stated
static	more static
stationary	more stationary
statuesque	more statuesque
stayed	more stayed
steadfast	more steadfast
stealing	more stealing
steamed	more steamed
steaming	more steaming
steeping	more steeping
steered	more steered
steering	more steering
stemmed	more stemmed
stepped	more stepped
stereotyped	more stereotyped
stereotyping	more stereotyping
sterile	more sterile
sterilized	more sterilized
stewed	more stewed
stewing	more stewing
sticking	more sticking
stiffened	more stiffened
stifled	more stifled
stifling	more stifling
stigmatized	more stigmatized
stimulated	more stimulated
stimulating	more stimulating
stinging	more stinging
stinking	more stinking
stirred	more stirred
stirring	more stirring
stitched	more stitched
stitching	more stitching
stocked	more stocked
stocking	more stocking
stockpiled	more stockpiled
stoic	more stoic
stolid	more stolid
stomping	more stomping
stoned	more stoned
stopping	more stopping
storing	more storing
storming	more storming
storytelling	more storytelling
stowed	more stowed
straggling	more straggling
straightening	more straightening
straightforward	more straightforward
strained	more strained
straining	more straining
straitlaced	more straitlaced
stranded	more stranded
strangling	more strangling
strapped	more strapped
strategic	more strategic
strategizing	more strategizing
stratified	more stratified
straying	more straying
streaked	more streaked
streaking	more streaking
streamed	more streamed
streaming	more streaming
streamlined	more streamlined
streetwise	more streetwise
strengthened	more strengthened
strengthening	more strengthening
strenuous	more strenuous
stressed	more stressed
stressful	more stressful
stretched	more stretched
stretching	more stretching
striated	more striated
striding	more striding
striking	more striking
stringed	more stringed
striped	more striped
stripping	more stripping
strolling	more strolling
struck	more struck
structured	more structured
struggling	more struggling
strumming	more strumming
strutting	more strutting
stuck	more stuck
studded	more studded
studied	more studied
studying	more studying
stuffed	more stuffed
stuffing	more stuffing
stumbling	more stumbling
stunned	more stunned
stunning	more stunning
stunted	more stunted
stupefying	more stupefying
stuttering	more stuttering
styled	more styled
styling	more styling
stylish	more stylish
stylized	more stylized
subcontracting	more subcontracting
subdued	more subdued
subjective	more subjective
subjugating	more subjugating
submerged	more submerged
submissive	more submissive
submitting	more submitting
subscribing	more subscribing
subservient	more subservient
subsidized	more subsidized
substantial	more substantial
substantiated	more substantiated
suburban	more suburban
succeeding	more succeeding
successful	more successful
succulent	more succulent
sucking	more sucking
suckling	more suckling
sudden	more sudden
suffered	more suffered
suffering	more suffering
sufficient	more sufficient
suffocating	more suffocating
sugared	more sugared
sugary	more sugary
suggesting	more suggesting
suing	more suing
suited	more suited
sulking	more sulking
summarizing	more summarizing
summoned	more summoned
summoning	more summoning
sumptuous	more sumptuous
sunbathing	more sunbathing
sunburned	more sunburned
sunk	more sunk
sunken	more sunken
super	more super
supercharged	more supercharged
superficial	more superficial
superheated	more superheated
superimposed	more superimposed
superior	more superior
supernatural	more supernatural
supersaturated	more supersaturated
superstitious	more superstitious
supervised	more supervised
supervising	more supervising
supplemented	more supplemented
supplementing	more supplementing
supplying	more supplying
supporting	more supporting
supportive	more supportive
suppressed	more suppressed
surefooted	more surefooted
surfacing	more surfacing
surfing	more surfing
surgical	more surgical
surging	more surging
surprised	more surprised
surprising	more surprising
surreal	more surreal
surrendering	more surrendering
surreptitious	more surreptitious
surrounding	more surrounding
surveyed	more surveyed
surveying	more surveying
surviving	more surviving
susceptible	more susceptible
suspected	more suspected
suspended	more suspended
suspending	more suspending
suspenseful	more suspenseful
suspicious	more suspicious
sustained	more sustained
sustaining	more sustaining
swaggering	more swaggering
swallowed	more swallowed
swallowing	more swallowing
swamped	more swamped
swapped	more swapped
swarming	more swarming
swashbuckling	more swashbuckling
swaying	more swaying
swearing	more swearing
sweating	more sweating
sweeping	more sweeping
sweetened	more sweetened
sweetening	more sweetening
swelled	more swelled
swelling	more swelling
sweltering	more sweltering
swept	more swept
swerving	more swerving
swimming	more swimming
swindling	more swindling
swinging	more swinging
swirling	more swirling
switched	more switched
switching	more switching
swollen	more swollen
swooping	more swooping
sworn	more sworn
swung	more swung
symbolic	more symbolic
symmetric	more symmetric
symmetrical	more symmetrical
sympathetic	more sympathetic
synchronised	more synchronised
synchronized	more synchronized
synchronizing	more synchronizing
syncopated	more syncopated
syndicated	more syndicated
synthesizing	more synthesizing
synthetic	more synthetic
syrupy	more syrupy
systematic	more systematic
taciturn	more taciturn
tackling	more tackling
tactile	more tactile
tactless	more tactless
tagging	more tagging
tailed	more tailed
tailored	more tailored
tailoring	more tailoring
talented	more talented
talentless	more talentless
talkative	more talkative
talking	more talking
tamed	more tamed
taming	more taming
tamping	more tamping
tangible	more tangible
tangled	more tangled
tangling	more tangling
tanned	more tanned
tantalizing	more tantalizing
taped	more taped
tapered	more tapered
tapering	more tapering
tapped	more tapped
tapping	more tapping
targeted	more targeted
targeting	more targeting
tarnished	more tarnished
tasteful	more tasteful
tasteless	more tasteless
tattered	more tattered
tattooed	more tattooed
taught	more taught
taunting	more taunting
taxable	more taxable
taxed	more taxed
taxiing	more taxiing
taxing	more taxing
taxpaying	more taxpaying
teaching	more teaching
teasing	more teasing
technical	more technical
tedious	more tedious
teeming	more teeming
teenaged	more teenaged
teetering	more teetering
teething	more teething
telemarketing	more telemarketing
telescoping	more telescoping
televised	more televised
temperamental	more temperamental
temperate	more temperate
tempered	more tempered
tempestuous	more tempestuous
templated	more templated
temporary	more temporary
tempting	more tempting
tenacious	more tenacious
tended	more tended
tending	more tending
tentacled	more tentacled
tentative	more tentative
tented	more tented
tenuous	more tenuous
tenured	more tenured
terminated	more terminated
terminating	more terminating
terraced	more terraced
terrified	more terrified
terrifying	more terrifying
territorial	more territorial
terrorized	more terrorized
terrorizing	more terrorizing
tested	more tested
testifying	more testifying
testing	more testing
tethered	more tethered
textured	more textured
thatched	more thatched
thawing	more thawing
theatrical	more theatrical
themed	more themed
theorized	more theorized
theorizing	more theorizing
thickened	more thickened
thickening	more thickening
thieving	more thieving
thinking	more thinking
thinned	more thinned
thinning	more thinning
thorough	more thorough
thoroughbred	more thoroughbred
thoughtful	more thoughtful
thoughtless	more thoughtless
thrashing	more thrashing
threaded	more threaded
threatened	more threatened
threatening	more threatening
thrilling	more thrilling
thriving	more thriving
throbbing	more throbbing
thronged	more thronged
throttled	more throttled
throwing	more throwing
thrown	more thrown
thrusting	more thrusting
thumbing	more thumbing
thumping	more thumping
thundering	more thundering
thunderous	more thunderous
thwarted	more thwarted
ticked	more ticked
ticking	more ticking
tickling	more tickling
tied	more tied
tiered	more tiered
tightened	more tightened
tightening	more tightening
tightlipped	more tightlipped
tiled	more tiled
tilling	more tilling
tilted	more tilted
tilting	more tilting
timbered	more timbered
timed	more timed
timeless	more timeless
timesaving	more timesaving
timing	more timing
tingling	more tingling
tinkering	more tinkering
tinkling	more tinkling
tinned	more tinned
tinted	more tinted
tipped	more tipped
tipping	more tipping
tireless	more tireless
tiresome	more tiresome
tiring	more tiring
titillating	more titillating
titled	more titled
toasted	more toasted
toasting	more toasting
toiling	more toiling
tolerant	more tolerant
tolerated	more tolerated
tolling	more tolling
toned	more toned
toning	more toning
toothed	more toothed
toothless	more toothless
toothsome	more toothsome
topical	more topical
topped	more topped
tormented	more tormented
tormenting	more tormenting
torpid	more torpid
tortured	more tortured
torturing	more torturing
torturous	more torturous
tossed	more tossed
tossing	more tossing
totaled	more totaled
totemic	more totemic
tottering	more tottering
touching	more touching
toughened	more toughened
touring	more touring
tousled	more tousled
towed	more towed
towering	more towering
towing	more towing
toxic	more toxic
traceable	more traceable
traced	more traced
tracing	more tracing
tracked	more tracked
tracking	more tracking
trackless	more trackless
tractable	more tractable
traded	more traded
trading	more trading
traditional	more traditional
trafficked	more trafficked
trafficking	more trafficking
tragic	more tragic
trailing	more trailing
trained	more trained
training	more training
tramping	more tramping
trampled	more trampled
trampling	more trampling
tranquil	more tranquil
tranquilizing	more tranquilizing
transcendent	more transcendent
transferred	more transferred
transferring	more transferring
transforming	more transforming
transient	more transient
transitioning	more transitioning
translated	more translated
translating	more translating
translucent	more translucent
transmitted	more transmitted
transmitting	more transmitting
transparent	more transparent
transplanted	more transplanted
transplanting	more transplanting
transportable	more transportable
transported	more transported
transporting	more transporting
trapped	more trapped
trapping	more trapping
trashed	more trashed
traumatic	more traumatic
traumatized	more traumatized
traumatizing	more traumatizing
traveling	more traveling
traversed	more traversed
trawling	more trawling
treacherous	more treacherous
treasured	more treasured
treated	more treated
treating	more treating
trekking	more trekking
trembling	more trembling
tremendous	more tremendous
trenchant	more trenchant
trending	more trending
trespassing	more trespassing
tricking	more tricking
trickling	more trickling
trifling	more trifling
triggered	more triggered
trimmed	more trimmed
trimming	more trimming
tripped	more tripped
trivial	more trivial
trolling	more trolling
trotting	more trotting
troubled	more troubled
troubleshooting	more troubleshooting
troublesome	more troublesome
troubling	more troubling
trucking	more trucking
trumpeting	more trumpeting
trusted	more trusted
trustful	more trustful
trusting	more trusting
truthful	more truthful
tufted	more tufted
tugging	more tugging
tumbling	more tumbling
tumultuous	more tumultuous
tuned	more tuned
tuneful	more tuneful
tuning	more tuning
tunneling	more tunneling
turbulent	more turbulent
turgid	more turgid
turning	more turning
tutored	more tutored
tutoring	more tutoring
tweaked	more tweaked
tweaking	more tweaking
twee	more twee
twiddling	more twiddling
twinkling	more twinkling
twirling	more twirling
twisted	more twisted
twisting	more twisting
twitching	more twitching
typed	more typed
typesetting	more typesetting
typing	more typing
tyrannical	more tyrannical
ubiquitous	more ubiquitous
umpiring	more umpiring
unabashed	more unabashed
unabridged	more unabridged
unacceptable	more unacceptable
unadorned	more unadorned
unaffiliated	more unaffiliated
unaligned	more unaligned
unalloyed	more unalloyed
unalterable	more unalterable
unaltered	more unaltered
unambiguous	more unambiguous
unannounced	more unannounced
unanswered	more unanswered
unanticipated	more unanticipated
unappetizing	more unappetizing
unapproachable	more unapproachable
unarmed	more unarmed
unassuming	more unassuming
unattached	more unattached
unattainable	more unattainable
unattractive	more unattractive
unauthorized	more unauthorized
unbalanced	more unbalanced
unbearable	more unbearable
unbecoming	more unbecoming
unbelievable	more unbelievable
unbelieving	more unbelieving
unbending	more unbending
unbiased	more unbiased
unbleached	more unbleached
unblemished	more unblemished
unbounded	more unbounded
unbreakable	more unbreakable
unbridled	more unbridled
unbuttoned	more unbuttoned
uncanny	more uncanny
uncaring	more uncaring
unceasing	more unceasing
uncensored	more uncensored
uncertain	more uncertain
unchallenged	more unchallenged
unchangeable	more unchangeable
unchanging	more unchanging
uncharitable	more uncharitable
uncharted	more uncharted
unchecked	more unchecked
uncivilized	more uncivilized
unclassified	more unclassified
unclean	more unclean
unclear	more unclear
uncluttered	more uncluttered
uncomfortable	more uncomfortable
uncommitted	more uncommitted
uncommon	more uncommon
uncommunicative	more uncommunicative
uncompensated	more uncompensated
uncomplicated	more uncomplicated
uncompressed	more uncompressed
uncompromising	more uncompromising
unconcerned	more unconcerned
unconfirmed	more unconfirmed
unconscious	more unconscious
uncontested	more uncontested
uncontrollable	more uncontrollable
uncontrolled	more uncontrolled
uncontroversial	more uncontroversial
unconventional	more unconventional
unconvinced	more unconvinced
unconvincing	more unconvincing
uncorrected	more uncorrected
uncorrupted	more uncorrupted
uncouth	more uncouth
uncovered	more uncovered
uncovering	more uncovering
uncredited	more uncredited
unctuous	more unctuous
uncultivated	more uncultivated
uncultured	more uncultured
undaunted	more undaunted
undecided	more undecided
undeclared	more undeclared
undefeated	more undefeated
undefined	more undefined
undemocratic	more undemocratic
undeniable	more undeniable
underachieving	more underachieving
underaged	more underaged
underdeveloped	more underdeveloped
underexposed	more underexposed
underlined	more underlined
underlining	more underlining
underlying	more underlying
undermining	more undermining
underperforming	more underperforming
underpinning	more underpinning
underprepared	more underprepared
underprivileged	more underprivileged
underqualified	more underqualified
understanding	more understanding
understated	more understated
undertaken	more undertaken
undervalued	more undervalued
underwriting	more underwriting
undeserved	more undeserved
undesirable	more undesirable
undesired	more undesired
undetected	more undetected
undeveloped	more undeveloped
undiagnosed	more undiagnosed
undifferentiated	more undifferentiated
undignified	more undignified
undiluted	more undiluted
undirected	more undirected
undisciplined	more undisciplined
undisclosed	more undisclosed
undiscovered	more undiscovered
undisguised	more undisguised
undisputed	more undisputed
undistinguished	more undistinguished
undisturbed	more undisturbed
undivided	more undivided
undocumented	more undocumented
undoubted	more undoubted
undressed	more undressed
undressing	more undressing
undulating	more undulating
undying	more undying
unearned	more unearned
unearthed	more unearthed
unedifying	more unedifying
unedited	more unedited
uneducated	more uneducated
unelected	more unelected
unemotional	more unemotional
unemployed	more unemployed
unencumbered	more unencumbered
unending	more unending
unenthusiastic	more unenthusiastic
unequal	more unequal
unequivocal	more unequivocal
unerring	more unerring
unethical	more unethical
uneven	more uneven
uneventful	more uneventful
unexcused	more unexcused
unexpected	more unexpected
unexpired	more unexpired
unexplained	more unexplained
unexploded	more unexploded
unexplored	more unexplored
unfair	more unfair
unfaithful	more unfaithful
unfathomable	more unfathomable
unfathomed	more unfathomed
unfeeling	more unfeeling
unfettered	more unfettered
unfiltered	more unfiltered
unfinished	more unfinished
unfit	more unfit
unflagging	more unflagging
unflappable	more unflappable
unflattering	more unflattering
unflinching	more unflinching
unfocused	more unfocused
unfolded	more unfolded
unfolding	more unfolding
unforeseeable	more unforeseeable
unforgettable	more unforgettable
unforgiving	more unforgiving
unformed	more unformed
unfortunate	more unfortunate
unfounded	more unfounded
unfree	more unfree
unfriendly	more unfriendly
unfulfilled	more unfulfilled
unfunny	more unfunny
unfurled	more unfurled
ungainly	more ungainly
ungrammatical	more ungrammatical
ungrateful	more ungrateful
unguided	more unguided
unhelpful	more unhelpful
unhindered	more unhindered
unhinged	more unhinged
unhurried	more unhurried
unidentified	more unidentified
unified	more unified
uniform	more uniform
uniformed	more uniformed
unifying	more unifying
unimaginative	more unimaginative
unimportant	more unimportant
unimpressive	more unimpressive
uninformative	more uninformative
uninformed	more uninformed
uninhabited	more uninhabited
uninhibited	more uninhibited
uninitiated	more uninitiated
uninspired	more uninspired
uninspiring	more uninspiring
uninsured	more uninsured
unintelligent	more unintelligent
unintelligible	more unintelligible
unintended	more unintended
unintentional	more unintentional
uninteresting	more uninteresting
uninterrupted	more uninterrupted
uninvited	more uninvited
uninviting	more uninviting
uninvolved	more uninvolved
unionized	more unionized
unique	more unique
unitary	more unitary
united	more united
unjust	more unjust
unjustified	more unjustified
unknowing	more unknowing
unlawful	more unlawful
unleashed	more unleashed
unlicensed	more unlicensed
unlimited	more unlimited
unlisted	more unlisted
unloaded	more unloaded
unloading	more unloading
unlocked	more unlocked
unlocking	more unlocking
unlovable	more unlovable
unloved	more unloved
unmanageable	more unmanageable
unmanly	more unmanly
unmanned	more unmanned
unmapped	more unmapped
unmarked	more unmarked
unmarried	more unmarried
unmatched	more unmatched
unmistakable	more unmistakable
unmitigated	more unmitigated
unmotivated	more unmotivated
unmoved	more unmoved
unnamed	more unnamed
unnatural	more unnatural
unnecessary	more unnecessary
unneeded	more unneeded
unnerving	more unnerving
unnoticeable	more unnoticeable
unnoticed	more unnoticed
unnumbered	more unnumbered
unobtrusive	more unobtrusive
unopened	more unopened
unopposed	more unopposed
unorganized	more unorganized
unpacked	more unpacked
unpaid	more unpaid
unpainted	more unpainted
unparalleled	more unparalleled
unpatriotic	more unpatriotic
unpaved	more unpaved
unplanned	more unplanned
unpleasant	more unpleasant
unplugged	more unplugged
unpolished	more unpolished
unpopular	more unpopular
unpredictable	more unpredictable
unprejudiced	more unprejudiced
unprepared	more unprepared
unpretentious	more unpretentious
unprincipled	more unprincipled
unproductive	more unproductive
unprofessional	more unprofessional
unproved	more unproved
unprovoked	more unprovoked
unpublished	more unpublished
unqualified	more unqualified
unquestioned	more unquestioned
unquestioning	more unquestioning
unraveling	more unraveling
unreachable	more unreachable
unreal	more unreal
unrealistic	more unrealistic
unrealized	more unrealized
unreasonable	more unreasonable
unreasoning	more unreasoning
unreciprocated	more unreciprocated
unrecognizable	more unrecognizable
unrecognized	more unrecognized
unreconstructed	more unreconstructed
unrefined	more unrefined
unregulated	more unregulated
unreleased	more unreleased
unrelenting	more unrelenting
unreliable	more unreliable
unremarkable	more unremarkable
unremitting	more unremitting
unrequited	more unrequited
unresolved	more unresolved
unresponsive	more unresponsive
unrestrained	more unrestrained
unrestricted	more unrestricted
unrestrictive	more unrestrictive
unrewarding	more unrewarding
unromantic	more unromantic
unruffled	more unruffled
unruly	more unruly
unsalted	more unsalted
unsanitary	more unsanitary
unsatisfied	more unsatisfied
unsavory	more unsavory
unsavoury	more unsavoury
unscheduled	more unscheduled
unscientific	more unscientific
unscripted	more unscripted
unscrupulous	more unscrupulous
unsealed	more unsealed
unsecured	more unsecured
unsentimental	more unsentimental
unsettled	more unsettled
unsettling	more unsettling
unsexy	more unsexy
unshaven	more unshaven
unsightly	more unsightly
unsigned	more unsigned
unsociable	more unsociable
unsolicited	more unsolicited
unsolved	more unsolved
unsophisticated	more unsophisticated
unsparing	more unsparing
unspoiled	more unspoiled
unstable	more unstable
unsteady	more unsteady
unstinting	more unstinting
unstoppable	more unstoppable
unstructured	more unstructured
unsubstantial	more unsubstantial
unsubstantiated	more unsubstantiated
unsubtle	more unsubtle
unsuited	more unsuited
unsullied	more unsullied
unsupported	more unsupported
unsuspecting	more unsuspecting
unswerving	more unswerving
unsympathetic	more unsympathetic
untalented	more untalented
untamed	more untamed
untangling	more untangling
untested	more untested
untethered	more untethered
unthinkable	more unthinkable
unthinking	more unthinking
untied	more untied
untiring	more untiring
untouchable	more untouchable
untouched	more untouched
untrained	more untrained
untreated	more untreated
untrustworthy	more untrustworthy
untruthful	more untruthful
unvarnished	more unvarnished
unvarying	more unvarying
unveiled	more unveiled
unverified	more unverified
unwanted	more unwanted
unwarranted	more unwarranted
unwashed	more unwashed
unwavering	more unwavering
unwelcome	more unwelcome
unwieldy	more unwieldy
unwilling	more unwilling
unwitting	more unwitting
unworldly	more unworldly
unwrapped	more unwrapped
unyielding	more unyielding
updated	more updated
upfront	more upfront
upheld	more upheld
upholstered	more upholstered
uplifting	more uplifting
uploaded	more uploaded
uploading	more uploading
upright	more upright
uprising	more uprising
uprooted	more uprooted
upstanding	more upstanding
upwelling	more upwelling
urbanized	more urbanized
urgent	more urgent
usurped	more usurped
uttered	more uttered
vacant	more vacant
vacationing	more vacationing
vaccinated	more vaccinated
vacillating	more vacillating
vacuous	more vacuous
vacuuming	more vacuuming
valiant	more valiant
valid	more valid
validated	more validated
valuable	more valuable
valued	more valued
valueless	more valueless
vandalized	more vandalized
vanilla	more vanilla
vanished	more vanished
vanishing	more vanishing
vaporous	more vaporous
varied	more varied
variegated	more variegated
varnishing	more varnishing
vascularized	more vascularized
vaulted	more vaulted
vaulting	more vaulting
vegetated	more vegetated
veil	more veil
veiled	more veiled
vending	more vending
venerated	more venerated
venomous	more venomous
vented	more vented
ventilated	more ventilated
ventilating	more ventilating
venturing	more venturing
verdant	more verdant
verified	more verified
verifying	more verifying
versatile	more versatile
versed	more versed
vertical	more vertical
vested	more vested
vexing	more vexing
viable	more viable
vibrant	more vibrant
vibrating	more vibrating
vicious	more vicious
victimized	more victimized
videotaped	more videotaped
viewing	more viewing
vigilant	more vigilant
vigorous	more vigorous
vindictive	more vindictive
violated	more violated
violating	more violating
violent	more violent
violet	more violet
viral	more viral
virile	more virile
virtuous	more virtuous
virulent	more virulent
visible	more visible
visited	more visited
visiting	more visiting
visual	more visual
vital	more vital
vitreous	more vitreous
vitrified	more vitrified
vivacious	more vivacious
vivifying	more vivifying
vocal	more vocal
vocalizing	more vocalizing
voiceless	more voiceless
void	more void
volatile	more volatile
volcanic	more volcanic
volunteering	more volunteering
voluptuous	more voluptuous
vomiting	more vomiting
voracious	more voracious
voting	more voting
vulgar	more vulgar
vulnerable	more vulnerable
waddling	more waddling
wading	more wading
waged	more waged
wagering	more wagering
wagging	more wagging
wailing	more wailing
waiting	more waiting
wakeful	more wakeful
walking	more walking
walled	more walled
wallowing	more wallowing
wandering	more wandering
wanted	more wanted
warbling	more warbling
warehousing	more warehousing
warmed	more warmed
warmhearted	more warmhearted
warming	more warming
warmongering	more warmongering
warning	more warning
warped	more warped
warring	more warring
warty	more warty
washed	more washed
washing	more washing
wasteful	more wasteful
wasting	more wasting
watchful	more watchful
watching	more watching
watered	more watered
waterlogged	more waterlogged
waterproof	more waterproof
waterproofing	more waterproofing
watertight	more watertight
watery	more watery
waved	more waved
wavering	more wavering
waving	more waving
waxed	more waxed
waxing	more waxing
weakening	more weakening
weaned	more weaned
weaning	more weaning
wearied	more wearied
wearing	more wearing
weathered	more weathered
weaving	more weaving
webbed	more webbed
wedded	more wedded
wee	more wee
weeding	more weeding
weeping	more weeping
weighing	more weighing
weighted	more weighted
weightless	more weightless
weightlifting	more weightlifting
welcomed	more welcomed
welcoming	more welcoming
welded	more welded
welding	more welding
welling	more welling
whacking	more whacking
whaling	more whaling
wheeled	more wheeled
wheeling	more wheeling
wheezing	more wheezing
whetted	more whetted
whimpering	more whimpering
whimsical	more whimsical
whinging	more whinging
whining	more whining
whipped	more whipped
whipping	more whipping
whirling	more whirling
whirring	more whirring
whispered	more whispered
whispering	more whispering
whistling	more whistling
whitewashed	more whitewashed
whittling	more whittling
wholehearted	more wholehearted
whooping	more whooping
whoring	more whoring
widened	more widened
widening	more widening
widespread	more widespread
widowed	more widowed
wiggling	more wiggling
wiggly	more wiggly
willing	more willing
wilted	more wilted
wilting	more wilting
winding	more winding
windsurfing	more windsurfing
winemaking	more winemaking
winged	more winged
winning	more winning
wintering	more wintering
winterized	more winterized
wintry	more wintry
wired	more wired
wireless	more wireless
wiretapping	more wiretapping
wiring	more wiring
wiry	more wiry
wisecracking	more wisecracking
wistful	more wistful
withered	more withered
withering	more withering
witnessed	more witnessed
witnessing	more witnessing
wizened	more wizened
wobbling	more wobbling
womanly	more womanly
wonderful	more wonderful
wooded	more wooded
wooden	more wooden
woodworking	more woodworking
wooing	more wooing
worded	more worded
worked	more worked
working	more working
worn	more worn
worried	more worried
worrisome	more worrisome
worrying	more worrying
worsening	more worsening
worshiped	more worshiped
worshipped	more worshipped
worshipping	more worshipping
worthless	more worthless
wound	more wound
wounded	more wounded
wounding	more wounding
woven	more woven
wrangling	more wrangling
wrapped	more wrapped
wrapping	more wrapping
wrecked	more wrecked
wrenching	more wrenching
wrestling	more wrestling
wretched	more wretched
wriggling	more wriggling
wriggly	more wriggly
wrinkled	more wrinkled
writhing	more writhing
writing	more writing
written	more written
wronged	more wronged
xenophobic	more xenophobic
yakking	more yakking
yapping	more yapping
yawning	more yawning
yearning	more yearning
yelled	more yelled
yelling	more yelling
yellowing	more yellowing
yelping	more yelping
yielding	more yielding
yodeling	more yodeling
youthful	more youthful
zapping	more zapping
zealous	more zealous
zipped	more zipped
zippered	more zippered
zipping	more zipping
zooming	more zooming
